abbhanujānātī=abbha-anujānātī
abbhaññiṃsū=abbhaññiṃ-sū
abbhokāsagatopi=abbhokāsagato-pi
abbhokāsikamattena=abbhokāsika-mattena
abhabboti=abhabbo-ti
abhayappattasuttaṃ=abhayappatta-suttaṃ
abhayappattoti=abhayappatto-ti
abhedanamukhāni=abhedana-mukhāni
abhibhosmi=abhibho-asmi
abhibhāyatanasuttaṃ=abhibhāyatana-suttaṃ
abhijjhampāhaṃ=abhijjham-pāhaṃ
abhijjhāpariyuṭṭhitena=abhijjhā-pariyuṭṭhitena
abhijjhāpariyuṭṭhānaṃ=abhijjhā-pariyuṭṭhānaṃ
abhikkantapaṭikkante=abhikkanta-paṭikkante
abhiramantīti=abhiramantī-ti
abhisamparāyañcā=abhisamparāyañ-cā
abhisamparāyañcāti=abhisamparāyañ-cāti
abhisandasuttaṃ=abhisanda-suttaṃ
abhivādanapaccuṭṭhānaañjalikammasāmīcikammacīvarapiṇḍapātasenāsana=abhivādanapaccuṭṭhānaañjalikamma-sāmīcikamma-cīvarapiṇḍapātasenāsana
abhivādanapaccuṭṭhānaañjalikammasāmīcikammānī=abhivādana-paccuṭṭhānaañjalikamma-sāmīci-kammānī
abhiyanteva=abhiyant-eva
abhiññatthā=abhiñña-atthā
abhiññāyo=abhiññā-yo
abhiṅkharitvā=abhiṅkhari-tvā
abhūtabbhakkhānasaṃvattaniko=abhūtabbhakkhāna-saṃvattaniko
abhūtenāyasmā=abhūtena-āyasmā
abrahmacariyavāso=abrahmacariya-vāso
abrahmacariyavāsā=abrahmacariya-vāsā
abrāhmaṇakārakā=abrāhmaṇa-kārakā
abyākaraṇadhammo=abyākaraṇa-dhammo
acchariyaabbhutasuttaṃ=acchariya-abbhuta-suttaṃ
acchariyaabbhutaṃ=acchariya-abbhutaṃ
aciravatīnadīupamā=aciravatī-nadī-upamā
adantaaguttasuttaṃ=adanta-agutta-suttaṃ
adassanakamyataṃ=adassana-kamyataṃ
adaṇḍāvacarā=adaṇḍā-vacarā
addhamidaṃ=addham-idaṃ
adhammacariyāsuttaṃ=adhammacariyā-suttaṃ
adhammacariyāvisamacariyāti=adhammacariyā-visama-cariyāti
adhammarāgarattānaṃ=adhamma-rāga-rattānaṃ
adhammañca=adhammañ-ca
adhammikañca=adhammikañ-ca
adhidevañāṇadassanaṃ=adhideva-ñāṇa-dassanaṃ
adhigamissatī=adhigami-ssatī
adhigatasaññī=adhigata-saññī
adhikaraṇakārako=adhikaraṇa-kārako
adhikaraṇanirodhagāminiṃ=adhikaraṇa-nirodhagāminiṃ
adhikaraṇanirodhaṃ=adhikaraṇa-nirodhaṃ
adhikaraṇasamathassa=adhikaraṇa-samathassa
adhikaraṇasamathā=adhikaraṇa-samathā
adhikaraṇasamudayaṃ=adhikaraṇa-samudayaṃ
adhikaraṇasamuppādavūpasamakusalo=adhikaraṇa-samuppāda-vūpasama-kusalo
adhikaraṇavaggo=adhikaraṇa-vaggo
adhimuttakamālaṃ=adhimuttaka-mālaṃ
adhimānasacco=adhimāna-sacco
adhimānasuttaṃ=adhimāna-suttaṃ
adhipaññādhammavipassanāyā=adhipaññā-dhamma-vipassanā-yā
adhivuttipadasuttaṃ=adhivutti-padasuttaṃ
adhivuttipadānaṃ=adhivutti-padānaṃ
adhiṭṭhahantopi=adhiṭṭhahanto-pi
adhomukhe=adho-mukhe
adinnādānampāhaṃ=adinnādānam-pāhaṃ
adukkhamasukhe=adukkhama-sukhe
aduṭṭhullāpattīti=aduṭṭhulla-āpattī-ti
agatapubbañceva=agata-pubbañ-ceva
aggaññasuttaṃ=aggañña-suttaṃ
aggaḷaphalake=aggaḷa-phalake
aggaḷasūciṃ=aggaḷa-sūciṃ
aggikajaṭilaupamā=aggika-jaṭila-upamā
aggiparicārikā=aggi-paricārikā
aggisaha=aggi-saha
aggisamphasso=aggi-samphasso
ahamāvuso=aham-āvuso
ahaṃāvusosarāmi=ahaṃ-āvuso-sarāmi
ahesuṃtiṇḍukamattiyo=ahesuṃ-tiṇḍuka-mattiyo
ahetuappaccayaṃ=ahetu-appaccayaṃ
ahetukavādo=ahetuka-vādo
ahirikoyaṃ=ahiriko-yaṃ
ahitānukampissa=ahita-anukampa-issa
ahosāhaṃ=ahosi-ahaṃ
ahuvatthā=ahu-vatthā
ajeṭṭhamaraṇaṃ=ajeṭṭha-maraṇaṃ
ajeṭṭhamaraṇaṃvāyaṃ=ajeṭṭha-maraṇaṃ-vāyaṃ
ajeṭṭhāpacāyinoti=ajeṭṭha-apacāyino-ti
ajitasuttaṃ=ajita-suttaṃ
ajjatagge=ajja-agge
ajjhattaaniccachandarāgasuttaṃ=ajjhatta-anicca-chandarāgasuttaṃ
ajjhattaaniccachandasuttaṃ=ajjhatta-anicca-chandasuttaṃ
ajjhattaaniccanandikkhayasuttaṃ=ajjhatta-anicca-nandikkhayasuttaṃ
ajjhattaaniccarāgasuttaṃ=ajjhatta-anicca-rāgasuttaṃ
ajjhattātītādianattasuttaṃ=ajjhatta-atīta-ādi-anattasuttaṃ
ajjhattāyatanaanattasuttaṃ=ajjhattāyatana-anattasuttaṃ
ajjhattāyatanaaniccasuttaṃ=ajjhattāyatana-aniccasuttaṃ
ajjhāpannapubbo=ajjhāpanna-pubbo
ajjhāvasantopi=ajjhāvasanto-pi
ajātasattuupāsakattapaṭivedanā=ajātasattu-upāsakatta-paṭivedanā
akasiralābhiniyo=akasira-lābhiniyo
akatabhīruttāṇo=akata-abhīruttāṇo
akatabhīruttāṇā=akata-abhīruttāṇā
akatabhīruttāṇānaṃ=akata-abhīruttāṇānaṃ
akaṇhaasukkaṃ=akaṇha-asukkaṃ
akaṇṭakanikkaṇṭakā=akaṇṭaka-nikkaṇṭakā
akaṭavidhā=akaṭa-vidhā
akhaṇḍakārī=akhaṇḍa-kārī
akhāditapubbāni=akhādita-pubbāni
akicchalābhiniyo=akiccha-lābhiniyo
akiriyavādaṃ=akiriya-vādaṃ
akkhadhuttakaupamā=akkha-dhuttaka-upamā
akkhaṇasuttaṃ=akkhaṇa-suttaṃ
akkhaṇavedhī=akkhaṇa-vedhī
akkhātabbānīti=akkhātabbānī-ti
akkosavaggo=akkosa-vaggo
akusalasañcetanikā=akusala-sañcetanikā
akusalasañcetanikāhetu=akusala-sañcetanikā-hetu
alaṃsuttaṃ=alaṃ-suttaṃ
allakusamuṭṭhiṃ=alla-kusa-muṭṭhiṃ
alābhopi=alābho-pi
alīnacitto=alīna-citto
amanāpasaddasaṃvattaniko=amanāpa-sadda-saṃvattaniko
amanāpasaṅkhātaṃ=amanāpa-saṅkhātaṃ
amatappattasuttaṃ=amatappatta-suttaṃ
amhehī=amhe-hī
ammakapaññā=ammaka-paññā
anabhisametaṃyassa=anabhisametaṃ-yassa
ananuruddhaappaṭiviruddhassā=ananuruddha-appaṭiviruddhassā
ananuruddhaappaṭiviruddhassāvuso=ananuruddha-appaṭiviruddhassa-āvuso
ananuruddhaappaṭiviruddhā=ananuruddha-appaṭiviruddhā
anapaloketvāva=anapaloke-tvāva
anariyadhammañca=anariya-dhammañca
anariyamaggañca=anariya-maggañ-ca
anariyavohārasuttaṃ=anariya-vohāra-suttaṃ
anattasaññāparicitañca=anattasaññā-paricitañca
anatthañca=anatthañ-ca
anavajjañca=anavajjañ-ca
anavajjāti=anavajjā-ti
anavasesāpattīti=anavasesa-āpattī-ti
anaññasaraṇo=anañña-saraṇo
anaññasaraṇā=anañña-saraṇā
anaññasaraṇānaṃ=anañña-saraṇānaṃ
anaṅgaṇasuttaṃ=anaṅgaṇa-suttaṃ
anekadhātuṃ=aneka-dhātuṃ
anekavassagaṇiko=aneka-vassagaṇa-iko
anekavihitañca=aneka-vihitañ-ca
aneḷamūgā=aneḷa-mūgā
aniccadassāvī=anicca-dassāvī
aniccadukkhaanattapahānaṃ=anicca-dukkha-anatta-pahānaṃ
aniccadukkhaanattato=anicca-dukkha-anattato
aniccasaññino=anicca-saññino
aniccasaññāparicitañca=anicca-saññā-paricitañ-ca
anicchāsaññā=anicchā-saññā
aniccucchādana=anicca-ucchādana
anidassanaappaṭighaṃ=anidassana-appaṭighaṃ
anidassanasappaṭighaṃ=anidassana-sappaṭighaṃ
anijjhattibalā=anijjhatti-balā
anissaraṇadassino=anissaraṇa-dassino
anissaraṇapañño=anissaraṇa-pañño
anissaraṇapaññā=anissaraṇa-paññā
annado=anna-do
antalikkhecarā=antalikkhe-carā
antarāmaggato=antarā-maggato
antopūtiṃ=anto-pūtiṃ
anucchedesu=anu-ucchedesu
anucchedesuevaṃ=anucchedesu-evaṃ
anucchedāevaṃ=anucchedā-evaṃ
anudisa=anu-disa
anuggahāyā=anuggahā-yā
anulomapaṭilomaṃ=anuloma-paṭilomaṃ
anumajjeyyāsi=anumajja-eyyāsi
anumattesu=anu-mattesu
anunnāmāninnāmi=anunnāma-aninnāmi
anuparivattatī=anu-parivattatī
anupasampannakathā=anupasampanna-kathā
anupetā=anu-petā
anupubbaninno=anupubba-ninno
anupubbanirodhasuttaṃ=anupubba-nirodhasuttaṃ
anupubbanirodhena=anupubba-nirodhena
anupubbanirodho=anupubba-nirodho
anupubbapabbhāro=anupubba-pabbhāro
anupubbapassaddhi=anupubba-passaddhi
anupubbapassaddhisuttaṃ=anupubbapassaddhi-suttaṃ
anupubbapassaddhīti=anupubba-passaddhī-ti
anupubbapoṇo=anupubba-poṇo
anupubbavihārasamāpattisuttaṃ=anupubba-vihāra-samāpattisuttaṃ
anupubbavihārasamāpattiyo=anupubba-vihāra-samāpattiyo
anupubbavihārasuttaṃ=anupubba-vihāra-suttaṃ
anupādinnā=anu-upādinnā
anupādisesoti=anupādiseso-ti
anupādāaparitassanā=anupādā-aparitassanā
anurodhavirodhasamāpanno=anurodha-virodha-samāpanno
anuruddhamahāvitakkasuttaṃ=anuruddha-mahāvitakka-suttaṃ
anusayasamugghātanatthaṃ=anusaya-samugghātan-atthaṃ
anussaritabbasuttaṃ=anussaritabba-suttaṃ
anussaritabbañca=anussari-tabbañ-ca
anussativaggo=anussati-vaggo
anusāsikā=anusāsi-kā
anuṭṭhānamalā=anuṭṭhāna-malā
anādeyyavācāsaṃvattaniko=anādeyya-vācā-saṃvattaniko
anādhānaggāhi=anādhāna-gāhi
anāvattidhammaṃ=anāvatti-dhammaṃ
anāvaṭadvāratāya=anāvaṭa-dvāratāya
anāvaṭadvāro=anāvaṭa-dvāro
anītisampadā=anīti-sampadā
anūsarañca=anūsarañ-ca
apacayagāmiñca=apacaya-gāmiñ-ca
apacayagāmī=apacaya-gāmī
aparaaccharāsaṅghātavaggo=apara-accharāsaṅghātavaggo
aparapuggalavaggo=apara-puggalavaggo
aparaṃkāraṃ=aparaṃ-kāraṃ
aparehipi=aparehi-pi
apariciṇṇapubbo=apariciṇṇa-pubbo
aparipuṇṇakammantā=aparipuṇṇa-kammantā
apayiṃsuyeva=apayiṃsu-yeva
aphāsukakāmā=aphāsuka-kāmā
apisuṇavāco=apisuṇa-vāco
appamādavagga=appamāda-vagga
appamādāya=appa-mā-dāya
appamāṇacetaso=appamāṇa-cetaso
appamāṇameko=appamāṇa-me-ko
appamāṇasamādhinā=appamāṇa-samādhinā
appamāṇasaññiṃ=appamāṇa-saññiṃ
appamāṇasaññī=appamāṇa-saññī
appamāṇasubhā=appamāṇa-subhā
appamāṇasubhānaṃ=appamāṇa-subhānaṃ
appamāṇavihārino=appamāṇa-vihārino
appamāṇavihārī=appamāṇa-vihārī
appanigghosaṃ=appa-nigghosaṃ
appapurisakāni=appa-purisakāni
apparajakkho=appa-rajakkho
appassute=appa-sute
appasādapavedanīyasuttaṃ=appasāda-pavedanīya-suttaṃ
appaḍaṃsamakasavātātapasarīsapasamphassaṃ=appa-ḍaṃsamakasavātātapasarīsapa-samphassaṃ
appaṭikammāpattīti=appaṭikamma-āpattīti
appaṭinissaggamantino=ap-paṭinissagga-mantino
appaṭinissajjacārikaṃ=appaṭinissajja-cārikaṃ
appicchatāyā=appicchatā-yā
appitthikāni=appa-itthi-kāni
appiyapasaṃsī=appiya-pasaṃsī
appossukkatāya=appossukka-tāya
appāyo=appā-yo
appāyukasaṃvattaniko=appāyuka-saṃvattaniko
aputhujjanasevitaṃ=aputhujjana-sevitaṃ
apuññabhāgiyaṃ=apuñña-bhāgiyaṃ
apāsāṇasakkharikañca=apāsā-ṇasa-kharikañ-ca
apāyasampannaṃ=apāya-sampannaṃ
apītapubbāni=apīta-pubbāni
arahattaphalampi=arahatta-phalam-pi
arahattappatto=arahatta-patto
arasarūpo=arasa-rūpo
aratiratiṃ=arati-ratiṃ
araññabhūta=arañña-bhūta
araññagataṃ=arañña-gataṃ
araññagato=arañña-gato
araññagatānaṃ=arañña-gatānaṃ
araññakuṭikā=arañña-kuṭikā
araññakuṭikāya=arañña-kuṭikāya
araññakuṭikāyaṃ=arañña-kuṭikāyaṃ
araññasaññaṃ=arañña-saññaṃ
araññasaññāya=arañña-saññāya
araññasaññāyā=arañña-saññāyā
araññasuttaṃ=arañña-suttaṃ
araññavaggo=arañña-vaggo
araññavanaṃ=arañña-vanaṃ
araññavihārena=arañña-vihārena
araññāyatanaisisuttaṃ=araññāyatanaisi-suttaṃ
araṇapaṭipadaṃ=araṇa-paṭipadaṃ
araṇasuttaṃ=araṇa-suttaṃ
araṇavibhaṅgassa=araṇa-vibhaṅgassa
araṇavibhaṅgaṃ=araṇa-vibhaṅgaṃ
araṇavihārīnaṃ=araṇa-vihārīnaṃ
ariyaaṭṭhaṅgikamaggesu=ariya-aṭṭhaṅgika-maggesu
ariyaaṭṭhaṅgikamaggo=ariya-aṭṭhaṅgika-maggo
ariyadhammasuttaṃ=ariya-dhamma-suttaṃ
ariyadhammañca=ariya-dhammañca
ariyamaggavaggo=ariya-magga-vaggo
ariyamaggañca=ariya-maggañ-ca
ariyapaccorohaṇīsuttaṃ=ariya-paccorohaṇī-suttaṃ
ariyasīlo=ariya-sīlo
ariyavaggo=ariya-vaggo
ariyavohārasuttaṃ=ariya-vohāra-suttaṃ
ariyāvāse=ariyā-vāse
ariyāvāsā=ariyā-vāsā
ariyūpavādo=ariya-upavādo
arūpabhavāyā=arūpa-bhavāyā
arūpīattāsuttaṃ=arūpī-attā-suttaṃ
asaddhammassavana=asaddhammassa-vana
asaddhammassavanampāhaṃ=asaddhamma-savanam-pāhaṃ
asaddhammassavanassa=asaddhammassa-vanassa
asaddhammassavanaṃ=asaddhamma-savanaṃ
asaddhammañca=asaddhammañ-ca
asadosadhammaṃ=asadosa-dhammaṃ
asajjhāyakiriyā=asajjhāya-kiriyā
asajjhāyamalā=asajjhāya-malā
asakyaputtiyadhammoti=asakyaputtiya-dhammoti
asamayavimutto=asamaya-vimutto
asamohadhammaṃ=asamoha-dhammaṃ
asamādhisaṃvattanikā=asamādhi-saṃvattanikā
asandiddhañca=asandiddhañ-ca
asandiṭṭhiparāmāsi=asandiṭṭhi-parāmāsi
asandiṭṭhiparāmāsianādhānaggāhi=asandiṭṭhi-parāmāsi-anādhāna-gāhi
asantañca=asantañ-ca
asappurisasambhattino=asappurisa-sambhattino
asappurisasaṃsevo=asappurisa-saṃsevo
asappāyakiriyā=asappāya-kiriyā
asarāgadhammaṃ=asarāga-dhammaṃ
asasmīti=asa-asmī-ti
asatiamanasikāraṃ=asati-amanasikāraṃ
asatiamanasikāro=asati-amanasikāro
asatāsampajañña=asatā-sampajañña
asatāsampajaññampāhaṃ=asata-asampajaññam-pāhaṃ
asatāsampajaññassa=asatā-sampajaññassa
asatāsampajaññaṃ=asatā-sampajaññaṃ
asayaṃkāraṃ=asayaṃ-kāraṃ
asaññasattā=asañña-sattā
asaññattibalā=asaññatti-balā
asaṃkiṇṇapubbaṃ=asaṃkiṇṇa-pubbaṃ
asaṃkiṇṇapubbā=asaṃkiṇṇa-pubbā
asaṃkiṇṇapubbāni=asaṃkiṇṇa-pubbāni
asaṃsaṭṭhakathañca=asaṃsaṭṭha-kathañca
asaṅkhatārammaṇā=asaṅkhata-ārammaṇā
asaṅkhāraparinibbāyissa=asaṅkhāra-parinibbāyissa
asaṅkiṇṇapubbā=asaṅkiṇṇa-pubbā
asekhāti=asekhā-ti
asevitabbopi=asevitabbo-pi
asevitabbopī=asevitabbo-pī
asilokabhayassa=asiloka-bhayassa
asilokabhayaṃ=asiloka-bhayaṃ
asmimānasamugghātaṃ=asmimāna-samugghātaṃ
asotukamyataṃ=asotu-kamyataṃ
assaddhammassavana=assaddhamma-savana
assaddhammassavanampāhaṃ=assaddhamma-savanam-pāhaṃ
assaddhammassavanassa=assaddhamma-savanassa
assaddhammassavanaṃ=assaddhamma-savanaṃ
assaddhiyampāhaṃ=assaddhiyam-pāhaṃ
assadose=assa-dose
assadoso=assa-doso
assadosā=assa-dosā
assakhaḷuṅkassa=assa-khaḷuṅkassa
assamaṇadhammo=assamaṇa-dhammo
assasammaddaṃ=assa-sammaddaṃ
assumukhiṃ=assu-mukhiṃ
assādaaratituṭṭhi=assāda-arati-tuṭṭhi
assādadassanahetu=assāda-dassana-hetu
assājānīyassa=assā-ājānīyassa
assānaṃ=assā-naṃ
asubhasaññāparicitañca=asubha-saññā-paricitañ-ca
asucikaraṇā=asuci-karaṇā
asuciyeva=asuci-yeva
asucīyeva=asucī-yeva
asurapuragatānañca=asurapura-gatānañ-ca
asurapuraṃyeva=asurapuraṃ-yeva
asādhuñca=asādhuñ-ca
asāraddhakāyo=asāraddha-kāyo
atapanīyañca=atapanīyañ-ca
athāsutaṃ=athā-sutaṃ
athāyasmā=athā-yasmā
atiracchānagāmino=atiracchāna-gāmino
atiracchānakathiko=atiracchāna-kathiko
atirekavīsativasso=atireka-vīsativasso
atiṇṇapubbaṃ=atiṇṇa-pubbaṃ
attabhāvā=atta-bhāvā
attahitaparahitaubhayahitasabbalokahitameva=attahita-parahita-ubhayahita-sabba-lokahita-meva
attantāpo=attan-tāpo
attasampattiṃ=atta-sampattiṃ
attavipattiṃ=atta-vipattiṃ
attavādī=atta-vādī
atthacariyānaṃ=attha-cariyānaṃ
atthapaccatthike=attha-paccatthike
atthasuttaṃ=attha-suttaṃ
atthoti=attho-ti
atthīti=atthī-ti
atthūpaparikkhitā=attha-upaparikkhitā
attukkaṃsakaparavambhakā=attukkaṃsaka-paravambhakā
avaṇṇakāmo=avaṇṇa-kāmo
avaṇṇakāmā=avaṇṇa-kāmā
aveccappasannasuttaṃ=avecca-pasanna-suttaṃ
aveccappasannā=avecca-pasannā
avijjaṇḍakosaṃ=avijja-aṇḍakosaṃ
avijjānivuto=avijjā-nivuto
avijjāpaccayāva=avijjā-paccaya-āva
avijjāyā=avijjā-yā
avikiṇṇavācena=avikiṇṇa-vācena
avikiṇṇavāco=avikiṇṇa-vāco
avikiṇṇavācā=avikiṇṇa-vācā
aviparītadassano=aviparīta-dassano
avippaṭisārasampannassa=avippaṭisāra-sampannassa
avippaṭisāratthāni=avippaṭisāra-atthāni
avippaṭisāravipannassa=avippaṭisāra-vipannassa
avippaṭisārānisaṃsāni=avippaṭisāra-ānisaṃsāni
avippaṭisārānisaṃsānī=avippaṭisāra-ānisaṃsānī
avippaṭisārāyā=avippaṭisāra-ayā
avipākajinassa=avipāka-jinassa
aviraḷadanto=aviraḷa-danto
avitakkaavicārampi=avitakka-avicāra-mpi
avitakkaavicāro=avitakka-avicāro
avitakkaavicārā=avitakka-avicārā
avitakkavicāramattampi=avitakkavicāra-mattam-pi
ayogakkhemakāmo=ayogakkhema-kāmo
ayogakkhemakāmā=ayogakkhema-kāmā
ayogakkhemino=ayoga-khemino
ayogakkhemīti=ayogakkhemī-ti
ayonisomanasikārahetu=ayoniso-manasikāra-hetu
ayonisomanasikārampāhaṃ=ayoniso-manasikāram-pāhaṃ
ayonisomanasikārassa=ayoniso-manasikārassa
ayonisomanasikāraṃ=ayoniso-manasikāraṃ
ayuddhaparājitaṃ=ayuddha-parājitaṃ
añjalikamma=añjali-kamma
añjalīhipi=añjalīhi-pi
aññadiṭṭhikena=añña-diṭṭhikena
aññakhantikena=añña-khantikena
aññamaññakhādikā=aññamañña-khādikā
aññamaññapaccayatā=aññamañña-paccayatā
aññarucikena=añña-rucikena
aññasmi=añña-asmi
aññatrayogena=aññatra-yogena
aññavihitakaṃ=añña-vihitakaṃ
aññavihitakena=añña-vihitakena
aññaṃjīvaṃaññaṃsarīraṃsuttaṃ=aññaṃ-jīvaṃ-aññaṃ-sarīraṃ-suttaṃ
aññenāññaṃ=aññe-nāññaṃ
aññāpaṭivedho=aññā-paṭivedho
aññāphalo=aññā-phalo
aññāṇadukkhā=aññāṇa-dukkhā
aññāṇakaraṇaṃ=aññāṇa-karaṇaṃ
aññāṇakaraṇo=aññāṇa-karaṇo
aññāṇakaraṇā=aññāṇa-karaṇā
aḍḍakaraṇasuttaṃ=aḍḍa-karaṇa-suttaṃ
aḍḍakaraṇaṃ=aḍḍa-karaṇaṃ
aḍḍakaraṇe=aḍḍa-karaṇe
aḍḍakaraṇena=aḍḍa-karaṇena
aḍḍhakahāpaṇaṃ=aḍḍha-kahāpaṇaṃ
aḍḍhavādaṃ=aḍḍha-vādaṃ
aḍḍhaṭṭharatano=aḍḍhaṭṭha-ratano
aṅgulipatodakena=aṅguli-patodakena
aṅguttarasamāyutā=aṅguttara-samāyutā
aṇḍabhāri=aṇḍa-bhāri
aṇḍabhūto=aṇḍa-bhūto
aṇḍabhūtā=aṇḍa-bhūtā
aṇḍabhūtāya=aṇḍa-bhūtāya
aṇḍahārako=aṇḍa-hārako
aṇḍakosamhā=aṇḍa-kosamhā
aṇḍakosaṃ=aṇḍa-kosaṃ
aṭṭhahākārehi=aṭṭhaha-ākārehi
aṭṭhakanipātapāḷi=aṭṭhaka-nipāta-pāḷi
aṭṭhamasuttaṃ=aṭṭhama-suttaṃ
aṭṭhaparivaṭṭaṃ=aṭṭha-parivaṭṭaṃ
aṭṭhaṅgasamannāgate=aṭṭhaṅga-samannāgate
aṭṭhaṅgasamannāgatesu=aṭṭhaṅga-samannāgatesu
aṭṭhaṅgasusamāgatā=aṭṭhaṅga-susamāgatā
aṭṭhaṅgike=aṭṭha-aṅgike
aṭṭhimā=aṭṭhi-mā
aṭṭhimāni=aṭṭhi-māni
aṭṭhiṃmiñjaṃ=aṭṭhiṃ-miñjaṃ
aṭṭhāhaṃ=aṭṭha-ahaṃ
aṭṭhānagatā=aṭṭhāna-gatā
aṭṭhānepi=aṭṭhāne-pi
aṭṭhānisaṃsā=aṭṭha-ānisaṃsā
aṭṭīyitvā=aṭṭīyi-tvā
bahidvārakoṭṭhakā=bahi-dvāra-koṭṭhakā
bahudukkho=bahu-dukkho
bahujanaahitāya=bahujana-ahitāya
bahujanaasukhāya=bahujana-asukhāya
bahulamakāsiṃ=bahulam-akāsiṃ
bahulīkātabbasuttaṃ=bahulīkātabba-suttaṃ
bahulīkātabbañca=bahulīkā-tabbañ-ca
bahuratano=bahu-ratano
bahussutoti=bahussuto-ti
balakaraṇīyavagga=bala-karaṇīya-vagga
balakaraṇīyavaggā=bala-karaṇīya-vaggā
balakaraṇīyaṃtadapi=balakaraṇīyaṃ-tadapi
balavamhi=balava-amhi
barihisatthāyā=barihisa-atthāyā
bavhābādhasaṃvattanikā=bavhābādha-saṃvattanikā
beḷuvasalāṭukamattiyo=beḷuvasalāṭuka-mattiyo
bhagavatopi=bhagavato-pi
bhajitabbādisuttāni=bhajitabba-ādi-suttāni
bhareyyāhaṃ=bhareyya-ahaṃ
bhavasaṅkhāro=bhava-saṅkhāro
bhavataṇhaṃ=bhava-taṇhaṃ
bhavataṇhāmpāhaṃ=bhavataṇhām-pāhaṃ
bhavataṇhāya=bhava-taṇhāya
bhayabheravo=bhaya-bheravo
bhayepi=bhaye-pi
bhaṇantassā=bhaṇanta-assā
bhaṇḍagāmo=bhaṇḍa-gāmo
bhaṇḍanakalahaviggahavivādā=bhaṇḍana-kalaha-viggaha-vivādā
bhaṇḍanāti=bhaṇḍanā-ti
bhedanasaṃvattaniko=bhedana-saṃvattaniko
bheravassa=bherava-assa
bhesajjaparikkhārāna=bhesajja-parikkhārāna
bhesajjaparikkhārānaṃ=bhesajja-parikkhārānaṃ
bhikkhuaparihāniyadhammā=bhikkhu-aparihāniya-dhammā
bhikkhumajjhagatopi=bhikkhu-majjha-gato-pi
bhikkhunidūsakakathā=bhikkhuni-dūsaka-kathā
bhikkhunidūsako=bhikkhuni-dūsako
bhikkhunisaṅghassa=bhikkhuni-saṅghassa
bhikkhunovādakasammuti=bhikkhunī-ovādaka-sammuti
bhikkhunovādako=bhikkhuno-vāda-ko
bhikkhunoāyuvaṇṇādivaḍḍhanakathā=bhikkhuno-āyuvaṇṇādivaḍḍhanakathā
bhikkhunīvaggo=bhikkhunī-vaggo
bhikkhusaṅghato=bhikkhu-saṅghato
bhikkhūnampi=bhikkhūnam-pi
bhikkhūsū=bhikkhū-sū
bhogabyasanasaṃvattaniko=bhoga-byasana-saṃvattaniko
bhogahetu=bhoga-hetu
bhoganidānaṃ=bhoga-nidānaṃ
bhogavāva=bhogavā-va
bhogavāvādaṃ=bhogavā-vādaṃ
bhogesū=bhoge-sū
bhogādhikaraṇaṃ=bhoga-adhikaraṇaṃ
bhojanasampadā=bhojana-sampadā
bhojjampi=bhojjam-pi
bhāsantī=bhāsa-ntī
bhāsitamassa=bhāsitam-assa
bhāvanāvādañca=bhāvanā-vādañ-ca
bhāvanāvādaṃ=bhāvanā-vādaṃ
bhāvetabbadhammasuttaṃ=bhāvetabba-dhamma-suttaṃ
bhāvetabbasuttaṃ=bhāvetabba-suttaṃ
bhāvetabbānī=bhāve-tabbānī
bhāvetī=bhāve-tī
bhāvitakāyomhi=bhāvita-kāyo-amhi
bhāṇavāro=bhāṇa-vāro
bhīruttānagatena=bhīruttāna-gatena
bhīruttāṇaṃ=bhīrutta-aṇaṃ
bhūmicālasuttaṃ=bhūmi-cāla-suttaṃ
bhūmicālavaggo=bhūmi-cāla-vaggo
bhūmicālenāti=bhūmi-cālenā-ti
billamattiyo=billa-mattiyo
biḷaṅgadutiya=biḷaṅga-dutiya
bodhisattaabhiniveso=bodhisatta-abhiniveso
bojjhasuttaṃ=bodhi-suttaṃ
brahmacariyaaparipūrādikathā=brahmacariya-aparipūra-adi-kathā
brahmacariyapañcamāni=brahmacariya-pañcamāni
brahmacāriabhipatthanenā=brahmacāri-abhipatthanenā
brahmacāripaṭiññaṃ=brahmacāri-paṭiññaṃ
brahmaññaphalāni=brahmañña-phalāni
brahmaññaphalānī=brahmañña-phalānī
brahmaññasaṅkhātā=brahmañña-saṅkhātā
brahmaññasuttaṃ=brahmañña-suttaṃ
brahmāsāmaññaambaṭṭha=brahmāsāmañña-ambaṭṭha
brāhmaṇacaṇḍālo=brāhmaṇa-caṇḍālo
brāhmaṇadhammo=brāhmaṇa-dhammo
brāhmaṇadhammā=brāhmaṇa-dhammā
brāhmaṇadūtā=brāhmaṇa-dūtā
brāhmaṇagahapatike=brāhmaṇa-gahapatike
brāhmaṇagahapatikehi=brāhmaṇa-gahapatikehi
brāhmaṇagahapatikesu=brāhmaṇa-gahapatikesu
brāhmaṇagahapatikā=brāhmaṇa-gahapatikā
brāhmaṇagahapatikānaṃ=brāhmaṇa-gahapatikānaṃ
brāhmaṇagaṇena=brāhmaṇa-gaṇena
brāhmaṇagāmaṃ=brāhmaṇa-gāmaṃ
brāhmaṇagāme=brāhmaṇa-gāme
brāhmaṇagāmo=brāhmaṇa-gāmo
brāhmaṇajaccā=brāhmaṇa-jaccā
brāhmaṇakaraṇā=brāhmaṇa-karaṇā
brāhmaṇakaññaṃ=brāhmaṇa-kaññaṃ
brāhmaṇakaññā=brāhmaṇa-kaññā
brāhmaṇakaññāya=brāhmaṇa-kaññāya
brāhmaṇakulassā=brāhmaṇa-kulassā
brāhmaṇakule=brāhmaṇa-kule
brāhmaṇakulā=brāhmaṇa-kulā
brāhmaṇakulīnā=brāhmaṇa-kulīnā
brāhmaṇakumārena=brāhmaṇa-kumārena
brāhmaṇakumāro=brāhmaṇa-kumāro
brāhmaṇakārakā=brāhmaṇa-kārakā
brāhmaṇamahāsālakulāni=brāhmaṇa-mahāsāla-kulāni
brāhmaṇapaccorohaṇīsuttaṃ=brāhmaṇa-paccorohaṇī-suttaṃ
brāhmaṇapadesaṃ=brāhmaṇa-padesaṃ
brāhmaṇaparibbājako=brāhmaṇa-paribbājako
brāhmaṇaparisaṃ=brāhmaṇa-parisaṃ
brāhmaṇaparisā=brāhmaṇa-parisā
brāhmaṇapaññatti=brāhmaṇa-paññatti
brāhmaṇapaṇḍite=brāhmaṇa-paṇḍite
brāhmaṇasaccena=brāhmaṇa-saccena
brāhmaṇasaccāni=brāhmaṇa-saccāni
brāhmaṇasaccānī=brāhmaṇa-saccānī
brāhmaṇasahassāni=brāhmaṇa-sahassāni
brāhmaṇasammatā=brāhmaṇa-sammatā
brāhmaṇasatāni=brāhmaṇa-satāni
brāhmaṇasaṃyuttaṃ=brāhmaṇa-saṃyuttaṃ
brāhmaṇasuttaṃ=brāhmaṇa-suttaṃ
brāhmaṇavaggo=brāhmaṇa-vaggo
brāhmaṇavaṇṇaṃ=brāhmaṇa-vaṇṇaṃ
brāhmaṇesū=brāhmaṇe-sū
brāhmaṇāmhāti=brāhmaṇa-amha-ti
byantibhūtaṃ=byanti-bhūtaṃ
byādhikaṃ=byādhi-kaṃ
byādhitopi=byādhito-pi
byākaraṇasuttaṃ=byākaraṇa-suttaṃ
byākatoti=byākato-ti
byākātabbākiṃ=byākātabbā-kiṃ
byāpādapariyuṭṭhānaṃ=byāpāda-pariyuṭṭhānaṃ
byāpādopi=byāpādo-pi
byāpādoti=byāpādo-ti
bāhiraaniccanandikkhayasuttaṃ=bāhira-anicca-nandikkhayasuttaṃ
bāhirātītādianattasuttaṃ=bāhira-atīta-ādi-anatta-suttaṃ
bāhirātītādianiccasuttaṃ=bāhira-atīta-ādi-anicca-suttaṃ
bāhirāyatanaanattasuttaṃ=bāhirāyatanaanatta-suttaṃ
bāhirāyatanaaniccasuttaṃ=bāhirāyatanaanicca-suttaṃ
bāhuvikkhepaṃ=bāhu-vikkhepaṃ
bālakhiḍḍā=bāla-khiḍḍā
bījasampadā=bīja-sampadā
bīraṇatthambakaṃ=bīraṇa-tthambakaṃ
cakkavattiacchariyasuttaṃ=cakkavatti-acchariya-suttaṃ
cakkhudo=cakkhu-do
cakkhurogo=cakkhu-rogo
canaca=ca-naca
candimasūriyaupamā=candima-sūriya-upamā
caratimanasā=carati-manasā
carativācāya=carati-vācāya
caraṇasampadā=caraṇa-sampadā
caraṇasampadāya=caraṇa-sampadāya
caraṇasampanno=caraṇa-sampanno
caraṇavipanno=caraṇa-vipanno
cassānupassati=cassā-anupassati
cassānupassatī=cassā-anupassatī
catthasampadaṃ=cattha-sampadaṃ
cattālīsaaviraḷadantalakkhaṇāni=cattālīsa-aviraḷa-danta-lakkhaṇāni
cattālīsamā=cattālīsa-mā
cattārīsachabbassasatāyukā=cattārīsa-chabbassa-sata-āyukā
cattārīsachabbassasatāyukānaṃ=cattārīsa-chabbassa-sata-āyukānaṃ
catuapāyamukhaṃ=catu-apāyamukhaṃ
catuariyaphalaṃ=catu-ariya-phalaṃ
catubbidhavacīkammanta=catubbidha-vacī-kammanta
catubbidhavacīkammantasampatti=catubbidha-vacī-kammanta-sampatti
catubbidhavacīkammantasampattikusalasañcetanikāhetu=catubbidha-vacī-kammanta-sampatti-kusala-sañcetanikā-hetu
catubbidhavacīkammantasandosabyāpatti=catubbidha-vacī-kammanta-sandosa-byāpatti
catubbidhā=catu-vidhā
catuiddhisamannāgato=catu-iddhi-samannāgato
catuppādako=catu-uppādako
caturāsītiassasahassānaṃ=caturāsīti-assasahassānaṃ
caturāsītiassasahassāni=caturāsīti-assasahassāni
caturāsītiitthisahassānaṃ=caturāsīti-itthi-sahassānaṃ
caturāsītiitthisahassāni=caturāsīti-itthi-sahassāni
catutthaabhabbaṭṭhānasuttaṃ=catuttha-abhabba-ṭhāna-suttaṃ
catutthaanudhammasuttaṃ=catuttha-anudhammasuttaṃ
catutthaanāgatabhayasuttaṃ=catuttha-anāgata-bhayasuttaṃ
catutthampāhaṃ=catuttham-pāhaṃ
catutthasamādhisuttaṃ=catuttha-samādhisuttaṃ
catutthasuttaṃ=catuttha-suttaṃ
catutthauposathasuttaṃ=catutthauposatha-suttaṃ
catutthaāmakadhaññapeyyālavaggo=catuttha-āmakadhañña-peyyāla-vaggo
catuttiṃsatimā=catu-tiṃsatimā
catuttālampi=catu-tālampi
catuyojana=catu-yojana
catuyojanasatikāpi=catu-yojana-satikā-pi
catūhāvuso=catūha-āvuso
caṇḍasunakhā=caṇḍa-sunakhā
caṇḍasuttaṃ=caṇḍa-suttaṃ
caṇḍālakumārakacaṇḍālakumārikāsamena=caṇḍāla-kumāraka-caṇḍāla-kumārikā-samena
caṇḍālakumārako=caṇḍāla-kumārako
caṇḍālakumārikā=caṇḍāla-kumārikā
cepi=ce-pi
cetanākaraṇīyasuttaṃ=cetanā-karaṇīya-suttaṃ
cetasovinibandhasuttaṃ=cetaso-vinibandhasuttaṃ
cetasovinibandhānaṃ=cetaso-vinibandhānaṃ
cetokhilānaṃ=ceto-khilānaṃ
cetosamādhissa=ceto-samādhissa
chabbassāni=cha-vassāni
chabbisodhanasuttaṃ=cha-visodhana-suttaṃ
chahāvuso=chah-āvuso
chandavasānugā=chanda-vasānugā
chattālampi=cha-tālam-pi
chayimābhikkhudhātuyo=chayimā-bhikkhu-dhātuyo
chaṭṭhasuttaṃ=chaṭṭha-suttaṃ
chedanavadhabandhanaviparāmosaālopasahasākārā=chedana-vadhabandhanaviparāmosa-ālopa-sahasākārā
chiddāvachiddaṃ=chidda-avachiddaṃ
chinnaggāni=chinna-aggāni
chinnapātaṃ=chinna-pātaṃ
chinnavisāṇo=chinna-visāṇo
chāyāpi=chāyā-pi
cidañca=cidañ-ca
ciranisinno=cira-nisinno
citi=ca-iti
cittahatthisāriputtaupasampadā=citta-hatthisāriputta-upasampadā
cittamaññāya=citta-maññāya
cittaparikkhāratthaṃ=citta-parikkhāratthaṃ
cittaṭṭhānasatāni=cittaṭṭhāna-satāni
codakaṃyeva=codakaṃ-yeva
corasamaṇena=cora-samaṇena
corasuttaṃ=cora-suttaṃ
coraupamā=cora-upamā
cāgasampannā=cāga-sampannā
cāgasampannānaṃ=cāga-sampannānaṃ
cāhāro=cā-hāro
cālikāpabbate=cālikā-pabbate
cārikāanujānanaṃ=cārikā-anujānanaṃ
cīdha=ca-idha
cīti=ca-iti
cīvarampāhaṃ=cīvaram-pāhaṃ
cīvarapiṇḍapātasenāsanagilānapaccayabhesajjaparikkhārehi=cīvarapiṇḍapātasenāsana-gilānapaccayabhesajja-parikkhārehi
cīvarapiṇḍapātasenāsanagilānapaccayabhesajjaparikkhārā=cīvarapiṇḍapātasenāsana-gilānapaccayabhesajja-parikkhārā
cīvarapiṇḍapātasenāsanagilānapaccayabhesajjaparikkhārāna=cīvarapiṇḍapātasenāsana-gilānapaccayabhesajja-parikkhārāna
cīvarapiṇḍapātasenāsanagilānappaccayabhesajjaparikkhāra=cīvara-piṇḍapāta-senāsana-gilānappaccayabhesajjaparikkhāra
cīvarapiṇḍapātasenāsanagilānappaccayabhesajjaparikkhārānuppadānena=cīvarapiṇḍapātasenāsanagilānappaccayabhesajjaparikkhāra-anuppadānena
cūḷaassapurasuttaṃ=cūḷa-assapura-suttaṃ
cūḷakokanadā=cūḷa-kokanadā
cūḷasīlaṃ=cūḷa-sīlaṃ
cūḷavaggo=cūḷa-vaggo
dahitvā=dahi-tvā
dakkhakammāraputtaukkāmukhasukusalasampahaṭṭhaṃ=dakkha-kammāra-putta-ukkāmukha-sukusalasampahaṭṭhaṃ
dakkhemoghataraṃ=dakkhem-ogha-taraṃ
dakkhiṇagirismiṃ=dakkhiṇa-girismiṃ
dakkhiṇajanapadaṃ=dakkhiṇa-janapadaṃ
dakkhiṇasuttaṃ=dakkhiṇa-suttaṃ
dakkhiṇenābhimukhā=dakkhiṇe-nābhi-mukhā
dantamha=danta-amha
dantarogo=danta-rogo
dasakanipātapāḷi=dasaka-nipāta-pāḷi
dasamasuttaṃ=dasama-suttaṃ
dasayime=dasa-ime
dasayimā=dasa-imā
dasayimāni=dasa-imāni
dassaneneva=dassane-neva
dassitaṃpāḷipotthakesu=dassi-taṃ-pāḷipotthakesu
dattosi=dattu-asi
davaḍāho=dava-ḍāho
daṇḍabhayassa=daṇḍa-bhayassa
daṇḍabhayaṃ=daṇḍa-bhayaṃ
daṇḍalakkhaṇaṃ=daṇḍa-lakkhaṇaṃ
daṇḍaparāyanaṃ=daṇḍa-parāyanaṃ
daṇḍaparāyaṇaṃ=daṇḍa-parāyaṇaṃ
daṇḍarāji=daṇḍa-rāji
daṇḍasamphassaṃ=daṇḍa-samphassaṃ
daṇḍasamphasso=daṇḍa-samphasso
daṇḍasuttaṃ=daṇḍa-suttaṃ
daṇḍatajjitā=daṇḍa-tajjitā
daṇḍavākarāhi=daṇḍa-vākarāhi
daṇḍayuddhaṃ=daṇḍa-yuddhaṃ
daṇḍādāna=daṇḍā-dāna
daṭṭhabboti=daṭṭhabbo-ti
devadattavipattisuttaṃ=devadatta-vipattisuttaṃ
devapadaṃ=deva-padaṃ
devapuragatānañca=devapura-gatānañ-ca
devapuraṃyeva=devapuraṃ-yeva
devehī=deve-hī
devāsurasaṅgāmasuttaṃ=devā-sura-saṅgāma-suttaṃ
dhammacariyāsamacariyāti=dhammacariyā-samacariyā-ti
dhammadānaṃ=dhamma-dānaṃ
dhammapāmojjassa=dhamma-pāmojjassa
dhammasotasamāpanno=dhamma-sota-samāpanno
dhammasuttaṃ=dhamma-suttaṃ
dhammasākacchāya=dhamma-sākacchāya
dhammasākacchāyā=dhammasākacchā-yā
dhammayogamhā=dhamma-yoga-amhā
dhammayogamhāti=dhamma-yoga-amhā-ti
dhammānudhammappaṭipattiyā=dhamma-anudhamma-paṭipattiyā
dhanakaraṇīye=dhana-karaṇīye
dhanavāva=dhanavā-va
dhanavāvādaṃ=dhanavā-vādaṃ
dhaññagaṇānaṃ=dhañña-gaṇānaṃ
dhaññagaṇāni=dhañña-gaṇāni
dhaññarāsissa=dhañña-rāsissa
dhaññasamavāpakaṃ=dhañña-samavāpakaṃ
dhaññasamaṃ=dhañña-samaṃ
dhovanasuttaṃ=dhovana-suttaṃ
dhāraṇajātiko=dhāraṇa-jātiko
disampati=disam-pati
diṭṭhadhammahitāya=diṭṭha-dhamma-hitāya
diṭṭhadhammanibbāna=diṭṭhadhamma-nibbāna
diṭṭhadhammanibbānasuttaṃ=diṭṭhadhamma-nibbāna-suttaṃ
diṭṭhadhammasukhavihāraṃyeva=diṭṭhadhammasukhavihāraṃ-yeva
diṭṭhadhammasukhāya=diṭṭha-dhamma-sukhāya
diṭṭhevadhamme=diṭṭha-eva-dhamme
diṭṭhiadhiṭṭhānaṃ=diṭṭhi-adhiṭṭhānaṃ
diṭṭhigatānaṃ=diṭṭhi-gatānaṃ
diṭṭhipariyuṭṭhānaṃ=diṭṭhi-pariyuṭṭhānaṃ
diṭṭhisampannā=diṭṭhi-sampannā
diṭṭhisampannānaṃ=diṭṭhi-sampannānaṃ
diṭṭhisamugghāto=diṭṭhi-samugghāto
diṭṭhisamuṭṭhānaṃ=diṭṭhi-samuṭṭhānaṃ
diṭṭhosi=diṭṭho-si
dosaabhiññādisuttāni=dosa-abhiñña-adi-suttāni
dosahetukampi=dosahetukam-pi
dosakkhayā=dosa-khayā
dosavinayapariyosāna=dosa-vinaya-pariyosāna
doṇabrāhmaṇasuttaṃ=doṇa-brāhmaṇa-suttaṃ
doṇamite=doṇa-mite
doṇasuttaṃ=doṇa-suttaṃ
dubbaṇṇakaraṇo=dubbaṇṇa-karaṇo
dubbaṇṇakaraṇī=dubbaṇṇa-karaṇī
dubbaṇṇasaṃvattanikā=dubbaṇṇa-saṃvattanikā
dubbharatāyā=dubbharatā-yā
dubbhāsitānamatthamaññātuṃ=dubbhāsitānam-attha-maññātuṃ
duccaritavipākasuttaṃ=duccarita-vipāka-suttaṃ
duggandhaṃyeva=duggandhaṃ-yeva
dukhañca=dukhañ-ca
dukkaṭakārinā=dukkaṭa-kārinā
dukkhametaṃ=dukkha-metaṃ
dukkhavedaniyañca=dukkha-vedaniyañ-ca
dukkhavipākasuttaṃ=dukkhavipāka-suttaṃ
dukkhavipākañca=dukkha-vipākañ-ca
dukkhopiyehi=dukkho-piyehi
dukkhudrayasuttaṃ=dukkha-udraya-suttaṃ
dukkhudrayañca=dukkha-udrayañ-ca
dukkhudrayo=dukkha-udrayo
dukūlasandhanāni=dukūla-sandhanāni
duppaññaeḷamūgasandosahetu=duppañña-eḷamūga-sandosa-hetu
duppaññajātiko=duppañña-jātiko
duppaññakavinā=duppañña-kavinā
duppaññasaṃvattanikā=duppañña-saṃvattanikā
duppaññasuttaṃ=duppañña-suttaṃ
duppaññenā=duppaññe-nā
dutiyaabhabbaṭṭhānasuttaṃ=dutiya-abhabba-ṭhāna-suttaṃ
dutiyaabhinivesasuttaṃ=dutiya-abhinivesasuttaṃ
dutiyaabhisandasuttaṃ=dutiya-abhisandasuttaṃ
dutiyaadhammasuttaṃ=dutiya-adhamma-suttaṃ
dutiyaagatisuttaṃ=dutiya-agati-suttaṃ
dutiyaaggasuttaṃ=dutiya-agga-suttaṃ
dutiyaaggisuttaṃ=dutiya-aggisuttaṃ
dutiyaagāravasuttaṃ=dutiya-agārava-suttaṃ
dutiyaakkhantisuttaṃ=dutiya-akkhanti-suttaṃ
dutiyaambasuttaṃ=dutiya-ambasuttaṃ
dutiyaanattasuttaṃ=dutiya-anattasuttaṃ
dutiyaaniccasuttaṃ=dutiya-aniccasuttaṃ
dutiyaanudhammasuttaṃ=dutiya-anudhammasuttaṃ
dutiyaanuruddhasuttaṃ=dutiya-anuruddhasuttaṃ
dutiyaanusayasuttaṃ=dutiya-anusayasuttaṃ
dutiyaanāgatabhayasuttaṃ=dutiya-anāgata-bhayasuttaṃ
dutiyaanāthapiṇḍikasuttaṃ=dutiya-anāthapiṇḍikasuttaṃ
dutiyaanāyussāsuttaṃ=dutiya-anāyussā-suttaṃ
dutiyaaparihānasuttaṃ=dutiya-aparihāna-suttaṃ
dutiyaaparijānanasuttaṃ=dutiya-aparijānana-suttaṃ
dutiyaappiyasuttaṃ=dutiya-appiya-suttaṃ
dutiyaaputtakasuttaṃ=dutiya-aputtaka-suttaṃ
dutiyaapāsādikasuttaṃ=dutiya-apāsādika-suttaṃ
dutiyaarahantasuttaṃ=dutiya-arahantasuttaṃ
dutiyaariyasāvakasuttaṃ=dutiya-ariyasāvakasuttaṃ
dutiyaariyāvāsasuttaṃ=dutiya-ariyā-vāsa-suttaṃ
dutiyaasappurisasuttaṃ=dutiya-asappurisa-suttaṃ
dutiyaasekhasuttaṃ=dutiya-asekhasuttaṃ
dutiyaassutavāsuttaṃ=dutiya-assutavāsuttaṃ
dutiyaassādapariyesanasuttaṃ=dutiya-assāda-pariyesana-suttaṃ
dutiyaassādasuttaṃ=dutiya-assādasuttaṃ
dutiyaavaṇṇārahasuttaṃ=dutiya-avaṇṇārahasuttaṃ
dutiyaavijjāpaccayasuttaṃ=dutiya-avijjāpaccayasuttaṃ
dutiyaavijjāpahānasuttaṃ=dutiya-avijjāpahānasuttaṃ
dutiyaaññatarabhikkhusuttaṃ=dutiya-aññatarabhikkhusuttaṃ
dutiyabalasuttaṃ=dutiya-balasuttaṃ
dutiyabandhanasuttaṃ=dutiya-bandhanasuttaṃ
dutiyadānasuttaṃ=dutiya-dāna-suttaṃ
dutiyaejāsuttaṃ=dutiya-ejā-suttaṃ
dutiyaekadhammapeyyālavaggo=dutiya-ekadhamma-peyyālavaggo
dutiyahatthakasuttaṃ=dutiya-hatthakasuttaṃ
dutiyaiddhipādasuttaṃ=dutiya-iddhipāda-suttaṃ
dutiyaidhalokikasuttaṃ=dutiya-idhalokika-suttaṃ
dutiyaisidattasuttaṃ=dutiya-isidatta-suttaṃ
dutiyakathāvatthusuttaṃ=dutiya-kathāvatthusuttaṃ
dutiyakosalasuttaṃ=dutiya-kosalasuttaṃ
dutiyalokadhammasuttaṃ=dutiya-loka-dhamma-suttaṃ
dutiyamahāpañhāsuttaṃ=dutiya-mahāpañhā-suttaṃ
dutiyampāhaṃ=dutiyam-pāhaṃ
dutiyanaḷakapānasuttaṃ=dutiya-naḷakapānasuttaṃ
dutiyanirayasaggasuttaṃ=dutiya-nirayasagga-suttaṃ
dutiyanoceassādasuttaṃ=dutiya-no-ce-assādasuttaṃ
dutiyanāthasuttaṃ=dutiya-nātha-suttaṃ
dutiyaovādasuttaṃ=dutiya-ovāda-suttaṃ
dutiyapaccorohaṇīsuttaṃ=dutiya-paccorohaṇī-suttaṃ
dutiyapuggalasuttaṃ=dutiya-puggalasuttaṃ
dutiyasaddhāsuttaṃ=dutiya-saddhā-suttaṃ
dutiyasambhejjaudakasuttaṃ=dutiya-sambhejjaudaka-suttaṃ
dutiyasañcetanikasuttaṃ=dutiya-sañcetanika-suttaṃ
dutiyasukhasuttaṃ=dutiya-sukhasuttaṃ
dutiyatathāgataacchariyasuttaṃ=dutiya-tathāgata-acchariya-suttaṃ
dutiyauggasuttaṃ=dutiya-ugga-suttaṃ
dutiyaupanisasuttaṃ=dutiya-upanisa-suttaṃ
dutiyaupanisāsuttaṃ=dutiya-upanisā-suttaṃ
dutiyaupaṭṭhākasuttaṃ=dutiya-upaṭṭhāka-suttaṃ
dutiyauposathasuttaṃ=dutiya-uposatha-suttaṃ
dutiyauppannasuttaṃ=dutiya-uppanna-suttaṃ
dutiyauppādasuttaṃ=dutiya-uppāda-suttaṃ
dutiyaupādāparitassanāsuttaṃ=dutiya-upādāparitassanā-suttaṃ
dutiyauruvelasuttaṃ=dutiya-uruvela-suttaṃ
dutiyaverasuttaṃ=dutiya-vera-suttaṃ
dutiyavisākhāsuttaṃ=dutiya-visākhā-suttaṃ
dutiyavivādamūlasuttaṃ=dutiya-vivādamūlasuttaṃ
dutiyaāghātapaṭivinayasuttaṃ=dutiya-āghātapaṭi-vinaya-suttaṃ
dutiyaāhuneyyasuttaṃ=dutiya-āhuneyya-suttaṃ
dutiyaājānīyasuttaṃ=dutiya-ājānīya-suttaṃ
dutiyaākāsasuttaṃ=dutiya-ākāsa-suttaṃ
dutiyaāmakadhaññapeyyālavaggo=dutiya-āmakadhañña-peyyāla-vaggo
dutiyaānandasuttaṃ=dutiya-ānanda-suttaṃ
dutiyaāyusuttaṃ=dutiya-āyu-suttaṃ
duṭṭhullāpattīti=duṭṭhulla-āpattī-ti
dvayaṃdvayasamāpattiṃ=dvayaṃ-dvaya-samāpattiṃ
dvirāvaṭṭaṃ=dvi-āvaṭṭaṃ
dviyojana=dvi-yojana
dviyojanasatikāpi=dvi-yojana-satikā-pi
dvīhāvuso=dvīha-āvuso
dānavatthusuttaṃ=dānavatthu-suttaṃ
dānūpapattisuttaṃ=dānūpapatti-suttaṃ
dāruṇasuttaṃ=dāruṇa-suttaṃ
dāyakopi=dāyako-pi
dīghajāṇusuttaṃ=dīghajāṇu-suttaṃ
dīgharattassa=dīgha-rattassa
dīghāsivudhehi=dīghāsi-āvudhehi
dīghāvuupāsakasuttaṃ=dīghāvu-upāsaka-suttaṃ
dūrevime=dūre-vime
dūsesīti=dūsesī-ti
ekabījissa=eka-bījissa
ekaccaasassatikā=ekacca-asassatikā
ekagatikā=eka-gatikā
ekamūlaanomiyaṃ=eka-mūla-anomiyaṃ
ekantaajjhosānā=ekanta-ajjhosānā
ekantaamanāpo=ekanta-amanāpo
ekantapaṭibhānā=ekanta-paṭibhānā
ekantasukhappaṭisaṃvedī=ekanta-sukhappaṭisaṃvedī
ekādasakanipātapāḷi=ekādasaka-nipāta-pāḷi
ekādasamasuttaṃ=ekādasama-suttaṃ
ekādasānisaṃsā=ekādasa-ānisaṃsā
eraṇḍakaṭṭhassa=eraṇḍa-kaṭṭhassa
esanādisuttadvādasakaṃ=esanā-di-sutta-dvādasakaṃ
esanāevaṃ=esanā-evaṃ
esanāvaggā=esanā-vaggā
etadavacaṃ=etad-avacaṃ
etthapāhaṃ=ettha-pāhaṃ
evamevassa=evam-evassa
evamāhārā=evam-āhārā
evassu=evaṃ-assu
evaṃabhisamparāyā=evaṃ-abhisamparāyā
evaṃadhippāyā=evaṃ-adhippāyā
evaṃadhippāyānaṃ=evaṃ-adhippāyānaṃ
evaṃanatīto=evaṃ-anatīto
evaṃantarāyakaraṃ=evaṃ-antarāyakaraṃ
evaṃappakasirena=evaṃ-appakasirena
evaṃciraṭṭhitikā=evaṃ-ciraṭṭhitikā
evaṃdiṭṭhinopi=evaṃ-diṭṭhino-pi
evaṃdiṭṭhīnampi=evaṃ-diṭṭhīnam-pi
evaṃpaṭipannānampi=evaṃ-paṭipannānam-pi
evaṃpaṭipannāpi=evaṃpaṭipannā-pi
evaṃsaññinopi=evaṃ-saññino-pi
evaṃsaññīnampi=evaṃ-saññīnam-pi
evaṃsaññīpi=evaṃsaññī-pi
evaṃsukhadukkhappaṭisaṃvediniyo=evaṃ-sukhadukkha-paṭisaṃvedi-niyo
evaṃvādinopi=evaṃ-vādino-pi
evaṃvādīnampi=evaṃ-vādīnam-pi
eḷamūgo=eḷa-mūgo
eḷamūgā=eḷa-mūgā
gabbhaseyyā=gabbha-seyyā
gabbhinīupamā=gabbhinī-upamā
gaddhabādhipubbassa=gaddha-bādhi-pubbassa
gahapatimahāsālakulāni=gahapati-mahā-sāla-kulāni
gahapatimahāsāle=gahapati-mahāsāle
gahaṇāpi=gahaṇā-pi
gamanāgamanasampannaṃ=gamanāgamana-sampannaṃ
gambhīrasitaṃ=gambhīra-sitaṃ
gamiyābhisaṅkhāro=gamiya-abhisaṅkhāro
gandhabhogā=gandha-bhogā
gandharasā=gandha-rasā
gandhohanamattampi=gandhohanamattam-pi
gantumarahati=gantum-arahati
garudhammaṃ=garu-dhammaṃ
garudhamme=garu-dhamme
garudhammā=garu-dhammā
garukāpattīti=garuka-āpattīti
gatisuttaṃ=gati-suttaṃ
gayāsīsasuttaṃ=gayāsīsa-suttaṃ
gaṅgānadīādisuttaṃ=gaṅgānadīādi-suttaṃ
gaṇakamoggallānasuttanteevaṃ=gaṇaka-moggallāna-suttante-evaṃ
gaṇarato=gaṇa-rato
gaṇasammudito=gaṇa-sammudito
gaṇḍabhūtaṃ=gaṇḍa-bhūtaṃ
gaṇḍabhūto=gaṇḍa-bhūto
gaṇḍamūla=gaṇḍa-mūla
gaṇḍamūlaṃ=gaṇḍa-mūlaṃ
gaṇḍasaññā=gaṇḍa-saññā
gaṇḍasuttaṃ=gaṇḍa-suttaṃ
ghaṭasuttaṃ=ghaṭa-suttaṃ
ghānarogo=ghāna-rogo
ghānañceva=ghānañ-ceva
ghāyeyyanti=ghāyeyyan-ti
gihipaṭissavaṃ=gihi-paṭissavaṃ
gilānapaccayabhesajjaparikkhārānuppadānenā=gilānapaccayabhesajja-parikkhārā-anuppadānenā
gilānappaccaya=gilāna-paccaya
gilānappaccayabhesajja=gilāna-paccaya-bhesajja
gilānappaccayabhesajjaparikkhāra=gilāna-paccaya-bhesajja-parikkhāra
gilānavuṭṭhito=gilāna-vuṭṭhito
girimānandasuttaṃ=girimānanda-suttaṃ
gocaramūlakaabhinīhārasuttādicatukkaṃ=gocara-mūlaka-abhinīhāra-sutta-adi-catukkaṃ
gocarapasutassa=gocara-pasutassa
gopālasuttaṃ=gopāla-suttaṃ
gotamīsuttaṃ=gotamī-suttaṃ
gotamīvaggo=gotamī-vaggo
guttadvāratāya=gutta-dvāra-tāya
guḷavālakāni=guḷa-vālakāni
gāmagatopi=gāmagato-pi
gāmanigamampāhaṃ=gāmanigamam-pāhaṃ
gāmanigamopi=gāmanigamo-pi
gāmantasambhatesu=gāmanta-sambhatesu
gāvīupamāsuttaṃ=gāvīupamā-suttaṃ
gāḷhūpalepanena=gāḷha-upalepanena
gūthabhārikaupamā=gūtha-bhārika-upamā
gūthakūpapurisaupamā=gūtha-kūpa-purisa-upamā
hatthicchāpehi=hatthicchāpa-ehi
hatthicchāpāpi=hatthicchāpā-pi
hatthikalabhehi=hatthi-kalabha-ehi
hatthikalabhāpi=hatthi-kalabhā-pi
hatthisahassāni=hatthi-sahassāni
hatthisammaddaṃ=hatthi-sammaddaṃ
hatthīpi=hatthī-pi
haṭabhakkho=haṭa-bhakkho
haṭahaṭakeso=haṭa-haṭa-keso
hemajālappaṭicchannāni=hemajāla-paṭicchannāni
hevamato=heva-mato
hevaṃāvuso=hevaṃ-āvuso
hiraññapūrāni=hirañña-pūrāni
hiraññasuvaṇṇassa=hirañña-suvaṇṇassa
hiraññasuvaṇṇaṃ=hirañña-suvaṇṇaṃ
hiraññasuvaṇṇenā=hirañña-suvaṇṇenā
hirīottappasuttaṃ=hirīottappa-suttaṃ
hirīparikkho=hirī-parikkho
hontikismiṃ=honti-kismiṃ
hontisaṅkhāresu=honti-saṅkhāresu
hānimetaṃ=hāni-metaṃ
hīnāyāvattī=hīnāya-āvattī
icchāmā=icchā-mā
icchāpariyuṭṭhitena=icchā-pariyuṭṭhitena
icchāpariyuṭṭhānaṃ=icchā-pariyuṭṭhānaṃ
icchāvinayassa=icchā-vinayassa
idamatthaṃtissa=idam-atthaṃ-tissa
idampānanda=idampi-ānanda
idaṃsu=idaṃ-su
iddhipāda=iddhi-pāda
iddhipādavaggo=iddhipāda-vaggo
iddhipādavasena=iddhipāda-vasena
idhalokampi=idha-lokam-pi
idhalokasaññā=idha-loka-saññā
idhalokasaññī=idha-lokasaññī
idhalokavijayāya=idha-loka-vijayāya
idhaloke=idha-loke
idhalokikā=idha-lokikā
imesampi=imesam-pi
imināvārahāmevāhaṃ=imināva-arahāma-evāhaṃ
indriyaasaṃvarampāhaṃ=indriya-asaṃvarampāhaṃ
indriyaasaṃvarassa=indriya-asaṃvarassa
indriyaasaṃvaraṃ=indriya-asaṃvaraṃ
indriyaasaṃvaro=indriya-asaṃvaro
indriyasaṃvara=indriya-saṃvara
indriyasaṃvarampāhaṃ=indriya-saṃvaram-pāhaṃ
indriyasaṃvarassa=indriya-saṃvarassa
indriyasaṃvaraṃ=indriya-saṃvaraṃ
issariyabalā=issariya-balā
issāpariyuṭṭhānaṃ=issā-pariyuṭṭhānaṃ
issāvādena=issā-vādena
itarītaracīvarapiṇḍapātasenāsanagilānapaccayabhesajjaparikkhārena=itarītara-cīvarapiṇḍapātasenāsana-gilānapaccayabhesajja-parikkhārena
itarītaracīvarapiṇḍapātasenāsanagilānapaccayabhesajjaparikkhārenā=itarītara-cīvarapiṇḍapātasenāsana-gilānapaccayabhesajja-parikkhārenā
itthasmīti=ittha-asmī-ti
itthidhutto=itthi-dhutto
iṇamūlāni=iṇa-mūlāni
iṇasuttaṃ=iṇa-suttaṃ
iṭṭhadhammasuttaṃ=iṭṭha-dhamma-suttaṃ
jalamaggisikhāriva=jalam-aggi-sikhā-iva
jambukhādakasaṃyuttaṃtathā=jambukhādaka-saṃyuttaṃ-tathā
jambumaṇḍassa=jambu-maṇḍassa
janapadakalyāṇīupamā=janapadakalyāṇī-upamā
janapadapadesaṃ=janapada-padesaṃ
janapadapadeso=janapada-padeso
janapadapadesopi=janapada-padeso-pi
jarāmaraṇa=jarā-maraṇa
jegucchiyaṃyeva=jegucchiyaṃ-yeva
jhānasuttaṃ=jhāna-suttaṃ
jhānāvuttā=jhānā-vuttā
jhāyiñca=jhāyiñ-ca
jhāyīhete=jhāyī-hete
jimhagatikassa=jimha-gatikassa
jimhupapattikassa=jimha-upapattika-assa
jivhañcase=jivhañ-case
jivhārogo=jivhā-rogo
jiṇṇapuriso=jiṇṇa-puriso
jiṇṇasuttaṃ=jiṇṇa-suttaṃ
jāgariyānuyogasmiṃ=jāgariya-anuyogasmiṃ
jānāmimaṃ=jānāmi-maṃ
jātijarūpetaṃ=jātijara-upetaṃ
jātimaraṇasaṃsāraṃ=jāti-maraṇa-saṃsāraṃ
jāṇussoṇivaggo=jāṇussoṇi-vaggo
jīvitamappamāyu=jīvitam-appam-āyu
jīvitamaraṇapariyādānā=jīvitamaraṇa-pariyādānā
kadalipattesu=kadali-pattesu
kahāpaṇasahassaṃ=kahāpaṇa-sahassaṃ
kahāpaṇasataṃ=kahāpaṇa-sataṃ
kahāpaṇasatānī=kahāpaṇa-satānī
kalahaviggahavivāda=kalaha-viggaha-vivāda
kalahaviggahavivādatuvaṃtuvaṃpesuññamusāvādā=kalaha-viggaha-vivāda-tuvaṃtuvaṃ-pesuñña-musāvādā
kallitamūlakaārammaṇasuttādichakkaṃ=kallita-mūlaka-ārammaṇa-sutta-di-chakkaṃ
kalyāṇadassano=kalyāṇa-dassano
kalyāṇadhammataro=kalyāṇa-dhammataro
kalyāṇadhammatā=kalyāṇa-dhammatā
kalyāṇadhammatāya=kalyāṇa-dhammatāya
kalyāṇadhammaṃ=kalyāṇa-dhammaṃ
kalyāṇadhamme=kalyāṇa-dhamme
kalyāṇadhammehi=kalyāṇa-dhammehi
kalyāṇadhammehī=kalyāṇa-dhammehī
kalyāṇadhammena=kalyāṇa-dhammena
kalyāṇadhammo=kalyāṇa-dhammo
kalyāṇadhammā=kalyāṇa-dhammā
kalyāṇadhammānaṃ=kalyāṇa-dhammānaṃ
kalyāṇakammaṃ=kalyāṇa-kammaṃ
kalyāṇakammā=kalyāṇa-kammā
kalyāṇakammānaṃ=kalyāṇa-kammānaṃ
kalyāṇakusalo=kalyāṇa-kusalo
kalyāṇakāmā=kalyāṇa-kāmā
kalyāṇakārī=kalyāṇa-kārī
kalyāṇamittassa=kalyāṇa-mittassa
kalyāṇamittatā=kalyāṇa-mittatā
kalyāṇamittatāya=kalyāṇa-mittatāya
kalyāṇamittaṃ=kalyāṇa-mittaṃ
kalyāṇamitte=kalyāṇa-mitte
kalyāṇamittena=kalyāṇa-mittena
kalyāṇamitto=kalyāṇa-mitto
kalyāṇamittā=kalyāṇa-mittā
kalyāṇapaṭibhāno=kalyāṇa-paṭibhāno
kalyāṇapaṭibhānā=kalyāṇa-paṭibhānā
kalyāṇapāpakānaṃ=kalyāṇa-pāpakānaṃ
kalyāṇasahāyassa=kalyāṇa-sahāyassa
kalyāṇasahāyatā=kalyāṇa-sahāyatā
kalyāṇasahāyo=kalyāṇa-sahāyo
kalyāṇasampavaṅkassa=kalyāṇa-sampavaṅkassa
kalyāṇasampavaṅkatā=kalyāṇa-sampavaṅkatā
kalyāṇasampavaṅko=kalyāṇa-sampavaṅko
kalyāṇasaṅgatiko=kalyāṇa-saṅgatiko
kalyāṇavāco=kalyāṇa-vāco
kammadheyyesu=kamma-dheyyesu
kammanidānasambhavo=kamma-nidānasambhavo
kammanidānasaṅkhayo=kamma-nidāna-saṅkhayo
kammanidānasuttaṃ=kamma-nidānasuttaṃ
kammantañceva=kammantañc-eva
kammapathehi=kamma-pathehi
kammapathānaṃ=kamma-pathānaṃ
kammapaṭisaraṇā=kamma-paṭisaraṇā
kammasampadaṃ=kamma-sampadaṃ
kammavipākajā=kamma-vipāka-jā
kappeyāma=kappe-yāma
karajakāyasuttaṃ=karajakāya-suttaṃ
karajakāyavaggo=karajakāya-vaggo
karajakāyena=karaja-kāyena
karaṇīyoti=karaṇīyo-ti
kasambujātaṃ=kasambu-jātaṃ
kasambujātāni=kasambu-jātāni
kasiṇasuttaṃ=kasiṇa-suttaṃ
kasiṇāyatanānaṃ=kasiṇa-āyatanānaṃ
kasiṇāyatanānī=kasiṇa-āyatanānī
katabhīruttāṇo=kata-abhīruttāṇo
katabhīruttāṇānaṃ=kata-abhīruttāṇānaṃ
katamassa=katam-assa
katasaññī=kata-saññī
kathaṃbhūtassa=kathaṃ-bhūtassa
kathināmo=kathi-nāmo
kathāvatthūnaṃ=kathā-vatthūnaṃ
kathāvatthūpare=kathā-vatthū-pare
katiaṅgika=kati-aṅgika
katthimāniko=katthi-māniko
katthīsuttaṃ=katthī-suttaṃ
kavitā=kavi-tā
kaḷopihattho=kaḷopi-hattho
kaṃsapātisahassāni=kaṃ-sapāti-sahassāni
kaṇabhakkho=kaṇa-bhakkho
kaṇahomaṃ=kaṇa-homaṃ
kaṇhamaggasuttaṃ=kaṇha-maggasuttaṃ
kaṇhamaggañca=kaṇha-maggañca
kaṇhamaggo=kaṇha-maggo
kaṇḍacitrakāni=kaṇḍa-citrakāni
kaṇḍakā=kaṇḍa-kā
kaṇṇajappanaṃ=kaṇṇa-jappanaṃ
kaṇṇarogo=kaṇṇa-rogo
kaṇṇasaṃdhovikampi=kaṇṇa-saṃdhovikam-pi
kaṇṇasotehi=kaṇṇa-sotehi
kaṇṇasotāni=kaṇṇa-sotāni
kaṇṇasukhā=kaṇṇa-sukhā
kaṇṇatelaṃ=kaṇṇa-telaṃ
kaṇṭakasuttaṃ=kaṇṭaka-suttaṃ
kevaṭṭasuttaṃ=kevaṭṭa-suttaṃ
khajjabhojjarasalābhiruttamaṃ=khajja-bhojja-rasa-lābhiruttamaṃ
khajjampi=khajjam-pi
khamāmahaṃ=khamā-mahaṃ
khantibalā=khanti-balā
khattiyamahāsālakulāni=khattiya-mahāsāla-kulāni
khattiyamahāsāle=khattiya-mahāsāle
khaḷuṅkajhāyitaṃ=khaḷuṅka-jhāyitaṃ
khaṇakicco=khaṇa-kicco
khaṇasuttaṃ=khaṇa-suttaṃ
khaṇḍadantaṃ=khaṇḍa-dantaṃ
khaṇḍakārī=khaṇḍa-kārī
khaṇḍaphullaṃ=khaṇḍa-phullaṃ
khaṇḍatissaṃ=khaṇḍa-tissaṃ
khemappattasuttaṃ=khema-patta-suttaṃ
khemappattoti=khemappatto-ti
khemavaggo=khema-vaggo
khettavatthūhi=khetta-vatthūhi
kheḷapiṇḍaṃ=kheḷa-piṇḍaṃ
khomayugaṃ=khoma-yugaṃ
khoyaṃ=kho-yaṃ
khvayyo=khva-ayyo
khvesa=khva-esa
khādanīyāni=khādanīya-āni
khīyanadhammaṃ=khīyana-dhammaṃ
khīṇasaṃyojanassa=khīṇa-saṃyojanassa
khīṇavādassa=khīṇa-vādassa
khīṇavādaṃ=khīṇa-vādaṃ
khīṇavādo=khīṇa-vādo
khīṇāsavaabhabbaṭhānaṃ=khīṇāsava-abhabba-ṭhānaṃ
khīṇāsavabalasuttaṃ=khīṇāsava-balasuttaṃ
khīṇāsavabalena=khīṇāsava-balena
khīṇāsavoti=khīṇāsavo-ti
kimānisaṃsa=kiṃ-ānisaṃsa
kimānisaṃsaṃ=kiṃ-ānisaṃsaṃ
kimānisaṃsā=kiṃ-ānisaṃsā
kimānisaṃsānī=kiṃ-ānisaṃsānī
kimārammaṇā=kiṃ-ārammaṇā
kissāhaṃ=kissa-ahaṃ
kittināma=kitti-nāma
kittisaddaabbhuggamanaṃ=kitti-sadda-abbhuggamanaṃ
kiñcanatasmi=kiñcanata-asmi
kiñcanatatthī=kiñcanata-atthī
kiñcāpāhaṃ=kiñca-apāhaṃ
kiṃabhinivesā=kiṃ-abhinivesā
kiṃadhipateyyā=kiṃ-adhipateyyā
kiṃadhippāyā=kiṃ-adhippāyā
kiṃadhiṭṭhānā=kiṃ-adhiṭṭhānā
kiṃdiṭṭhikasuttaṃ=kiṃ-diṭṭhika-suttaṃ
kiṃdiṭṭhiko=kiṃ-diṭṭhiko
kiṃdiṭṭhikosi=kiṃ-diṭṭhikosi
kiṃdiṭṭhikā=kiṃ-diṭṭhikā
kiṃogadhā=kiṃ-ogadhā
kiṃpamukhā=kiṃ-pamukhā
kiṃphalo=kiṃ-phalo
kiṃsambhavā=kiṃ-sambhavā
kiṃsamosaraṇā=kiṃ-samosaraṇā
kiṃsaññī=kiṃ-saññī
kiṃsārā=kiṃ-sārā
kiṃuttarā=kiṃ-uttarā
kodhapariyuṭṭhitena=kodha-pariyuṭṭhitena
kodhapariyuṭṭhānaṃ=kodha-pariyuṭṭhānaṃ
kodhavinayassa=kodha-vinayassa
kokanudasuttaṃ=kokanuda-suttaṃ
kokanudopi=kokanudo-pi
koṇḍaññasuttaṃ=koṇḍañña-suttaṃ
koṭṭhikaanattasuttaṃ=koṭṭhika-anattasuttaṃ
koṭṭhikaaniccasuttaṃ=koṭṭhika-aniccasuttaṃ
kucchirogo=kucchi-rogo
kucchisayā=kucchi-āsayā
kudhārīhi=ku-dhārī-hi
kuhakāssaddhaakkhamā=kuhaka-assaddha-akkhamā
kukkuraabhayo=kukkura-abhayo
kukkuḷasuttaṃ=kukkuḷa-suttaṃ
kukkuḷavaggo=kukkuḷa-vaggo
kukkuṭabhūtānaṃ=kukkuṭa-bhūtānaṃ
kukkuṭacchāpakānaṃ=kukkuṭa-chāpakānaṃ
kukkuṭalakkhaṇaṃ=kukkuṭa-lakkhaṇaṃ
kukkuṭapattaṃ=kukkuṭa-pattaṃ
kukkuṭapotakā=kukkuṭa-potakā
kukkuṭasampātikā=kukkuṭa-sampātikā
kukkuṭasaṃpātikā=kukkuṭa-saṃpātikā
kukkuṭasūkaraṃ=kukkuṭa-sūkaraṃ
kukkuṭasūkarā=kukkuṭa-sūkarā
kukkuṭayuddhaṃ=kukkuṭa-yuddhaṃ
kulagaṇṭhikajātā=kula-gaṇṭhika-jātā
kumbhaṇḍapacāro=kumbhaṇḍa-pacāro
kumbhaṇḍapotako=kumbhaṇḍa-potako
kumbhaṇḍapotikā=kumbhaṇḍa-potikā
kumbhaṇḍapārisajjo=kumbhaṇḍa-pārisajjo
kumbhaṇḍasenāya=kumbhaṇḍa-senāya
kummaggasevanaṃ=kummagga-sevanaṃ
kumāripañhesu=kumāri-pañhesu
kusaladhammatāya=kusala-dhammatāya
kusaladhamme=kusala-dhamme
kusalasañcetanikā=kusala-sañcetanikā
kusalasuttaṃ=kusala-suttaṃ
kusalasīlo=kusala-sīlo
kusalākusalasāvajjānavajjasevitabbāsevitabbahīna=kusala-akusala-sāvajjā-anavajja-sevitabba-asevitabba-hīna
kusināraacinteyyā=kusināra-acinteyyā
kusinārapavesane=kusināra-pavesane
kusītārambhavatthusuttaṃ=kusīta-ārambha-vatthu-suttaṃ
kusītārambhavatthūnīti=kusīta-ārambha-vatthūnī-ti
kuṭhāripāsena=kuṭhāri-pāsena
kuṭṭamūlaṃ=kuṭṭa-mūlaṃ
kuṭṭanissitā=kuṭṭa-nissitā
kācimā=kāci-mā
kājehipi=kājehi-pi
kākasuttaṃ=kāka-suttaṃ
kālattayaanattasuttaṃ=kālattaya-anattasuttaṃ
kālattayaaniccasuttaṃ=kālattaya-aniccasuttaṃ
kāmabhavāyā=kāma-bhavāyā
kāmabhogīsuttaṃ=kāmabhogī-suttaṃ
kāmandubandhanabaddhā=kāmandu-bandhana-baddhā
kāmaratā=kāma-ratā
kāmaratānaṃ=kāma-ratānaṃ
kāmasammuditā=kāma-sammuditā
kāmasammuditānaṃ=kāma-sammuditānaṃ
kāmesumicchācārampāhaṃ=kāmesu-micchācāram-pāhaṃ
kāmesumicchācārissa=kāmesumicchā-cārissa
kāraṇḍavasuttaṃ=kāraṇḍava-suttaṃ
kāsāyavatthanivasanāya=kāsāyavattha-nivasanāya
kāyakammanta=kāya-kammanta
kāyakammantasampatti=kāya-kammanta-sampatti
kāyakammantasandosabyāpatti=kāya-kammanta-sandosa-byāpatti
kāyarogo=kāya-rogo
kāyasakkhīsuttaṃ=kāyasakkhī-suttaṃ
kāyasamācārena=kāya-samācārena
kāḷajallikā=kāḷa-jallikā
kāḷakeso=kāḷa-keso
kāḷakesā=kāḷa-kesā
kāḷapabbāni=kāḷa-pabbāni
kāḷapakkhe=kāḷa-pakkhe
kāḷasilā=kāḷa-silā
kāḷasilāyaṃ=kāḷa-silāyaṃ
kāḷasīso=kāḷa-sīso
kāḷavatthaṃ=kāḷa-vatthaṃ
kāḷīsuttaṃ=kāḷī-suttaṃ
kūṭadantaupāsakattapaṭivedanā=kūṭadanta-upāsakatta-paṭivedanā
kūṭakammena=kūṭa-kammena
kūṭaninnā=kūṭa-ninnā
kūṭapabbhārā=kūṭa-pabbhārā
kūṭapoṇā=kūṭa-poṇā
kūṭasamosaraṇā=kūṭa-samosaraṇā
kūṭasamugghātā=kūṭa-samugghātā
kūṭasuttaṃ=kūṭa-suttaṃ
labbhāti=labbhā-ti
laddhādhippāyo=laddha-adhippāyo
lahukāpattīti=lahuka-āpattīti
lajjāti=lajjā-ti
lakkhaṇacintī=lakkhaṇa-cintī
lakkhaṇakusalo=lakkhaṇa-kusalo
lakkhaṇasaṃyuttaṃ=lakkhaṇa-saṃyuttaṃ
lakkhaṇasuttaṃ=lakkhaṇa-suttaṃ
laṇḍasāraṇo=laṇḍa-sāraṇo
leyyampi=leyyam-pi
lobhahetukampi=lobha-hetukam-pi
lobhakkhayā=lobha-khayā
lohitakasiṇasamāpattiparamā=lohita-kasiṇa-samāpatti-paramā
lokadhammesu=loka-dhammesu
lokapariyāpanno=loka-pariyāpanno
loṇaghaṭāya=loṇa-ghaṭāya
loṇakapallakaṃ=loṇa-kapallakaṃ
loṇakapallaṃ=loṇa-kapallaṃ
loṇakapallena=loṇa-kapallena
loṇaraso=loṇa-raso
loṇasakkharāya=loṇa-sakkharāya
loṇasovīrakena=loṇa-sovīrakena
lābhopi=lābho-pi
līnacitto=līna-citto
lūkhajīvino=lūkha-jīvino
lūkhajīviṃ=lūkha-jīviṃ
lūkhajīvī=lūkha-jīvī
lūkhañcepi=lūkhañ-cepi
maccherapariyuṭṭhitena=macchera-pariyuṭṭhitena
maccherapariyuṭṭhānaṃ=macchera-pariyuṭṭhānaṃ
maggasampadamāgamma=magga-sampadam-āgamma
maggasaṃyuttaṃtathā=maggasaṃyuttaṃ-tathā
maggāmaggañāṇadassanahetu=maggāmaggañāṇadassana-hetu
maggāmaggañāṇadassanamaddasa=maggāmagga-ñāṇa-dassanam-addasa
maghadevaambavane=maghadeva-ambavane
mahaggatameko=mahaggata-me-ko
mahagghaso=maha-ghaso
mahantassa=mahanta-assa
mahapphalatara=maha-phala-tara
mahassādaṃ=maha-sādaṃ
mahesakkhasaṃvattanikaṃ=mahesakkha-saṃvattanikaṃ
mahimaṃ=mahiṃ-imaṃ
mahāaggiḍāhe=mahā-aggi-ḍāhe
mahāaggiḍāho=mahā-aggi-ḍāho
mahāakālamegho=mahā-akāla-megho
mahāariṭṭhako=mahā-ariṭṭhako
mahāassapurasuttaṃ=mahā-assapura-suttaṃ
mahābrahmunopi=mahā-brahmuno-pi
mahābyūhaṃ=mahā-byūhaṃ
mahācariyena=mahā-cariyena
mahācūḷadukkhakkhandhaanumānikasuttaṃ=mahā-cūḷa-dukkha-khandha-anumānika-suttaṃ
mahādhaññarāsi=mahā-dhañña-rāsi
mahādhaññarāsimhā=mahā-dhañña-rāsimhā
mahādāna=mahā-dāna
mahādānaṃ=mahā-dānaṃ
mahādānāni=mahā-dānāni
mahājanakāyaanupabbajjā=mahā-jana-kāya-anupabbajjā
mahājutikaṃ=mahā-jutikaṃ
mahāpañhesu=mahā-pañhesu
mahāpañhā=mahā-pañhā
mahāpañhāsu=mahā-pañhā-su
mahāpurisavitakkaṃ=mahā-purisa-vitakkaṃ
mahāpurisavitakke=mahā-purisa-vitakke
mahāpuṇṇacūḷapuṇṇañcāti=mahā-puṇṇa-cūḷa-puṇṇañ-cāti
mahāsamuddassa=mahā-samuddassa
mahāsāvakā=mahā-sāvakā
mahāudakarahado=mahā-udakarahado
mahāvipphāra=mahā-vipphāra
mahāvipphāraṃ=mahā-vipphāraṃ
mahāyo=mahā-yo
majjhimānukampitassa=majjhimā-anukampi-tassa
majjhimāpi=majjhimā-pi
makkaṭasuttaṃ=makkaṭa-suttaṃ
makkaṭavīthīsu=makkaṭa-vīthīsu
makkhapariyuṭṭhitena=makkha-pariyuṭṭhitena
makkhapariyuṭṭhānaṃ=makkha-pariyuṭṭhānaṃ
makkhavinayassa=makkha-vinayassa
malitthiyā=mali-itthiyā
mamaccaye=mama-accaye
manasikārasambhavā=manasikāra-sambhavā
manasikārasuttaṃ=manasikāra-suttaṃ
manasānukampī=manasānukam-pī
manañcano=manañ-cano
manejā=mane-jā
manobhāvanīyānaṃ=mano-bhāvanīya-ānaṃ
manobhāvanīyāpi=mano-bhāvanīya-api
manokammanta=mano-kammanta
manokammantasampatti=manokammanta-sampatti
manokammantasandosabyāpatti=manokammanta-sandosa-byāpatti
manokammanto=mano-kammanto
manubhoti=manu-bhoti
manubrūhaye=manu-brūhaye
manussadhammo=manussa-dhammo
manussadobhagyaṃ=manussa-dobhagyaṃ
manussalābhaṃ=manussa-lābhaṃ
manussapaṭilābho=manussa-paṭilābho
manussasobhagyaṃ=manussa-sobhagyaṃ
manuññabhojanaṃ=manuñña-bhojanaṃ
maraṇabhaya=maraṇa-bhaya
maraṇabhayassa=maraṇa-bhayassa
maraṇabhayaṃ=maraṇa-bhayaṃ
maraṇadhammaṃ=maraṇa-dhammaṃ
maraṇadhamme=maraṇa-dhamme
maraṇadhammino=maraṇa-dhammino
maraṇadhammo=maraṇa-dhammo
maraṇadhammā=maraṇa-dhammā
maraṇadhammānaṃ=maraṇa-dhammānaṃ
maraṇakāle=maraṇa-kāle
maraṇamattaṃ=maraṇa-mattaṃ
maraṇapariyosānā=maraṇa-pariyosānā
maraṇasabhaye=maraṇa-sabhaye
maraṇasaññaṃ=maraṇa-saññaṃ
maraṇasaññā=maraṇa-saññā
maraṇasaṃvattanikesu=maraṇa-saṃvattanikesu
maraṇasuttaṃ=maraṇa-suttaṃ
maraṇavadhena=maraṇa-vadhena
maraṇañca=maraṇañ-ca
mariyādasampannaṃ=mariyāda-sampannaṃ
mattikāpuñje=mattikā-puñje
mayānusiṭṭhaṃ=maya-anusiṭṭhaṃ
mañcepi=mañce-pi
maṅkubhūte=maṅku-bhūte
medenti=me-denti
meghiyasuttaṃ=meghiya-suttaṃ
mettaṃso=mettaṃ-so
mettāvaggo=mettā-vaggo
mettūpahāraṃ=mettā-upahāraṃ
meṇḍalakkhaṇaṃ=meṇḍa-lakkhaṇaṃ
meṇḍayuddhaṃ=meṇḍa-yuddhaṃ
micchādiṭṭhimpāhaṃ=miccha-adiṭṭhimpāhaṃ
micchākammantapaccayā=micchā-kammanta-paccayā
micchāsamādhimhā=miccha-asamādhi-amhā
micchāsamādhipaccayā=micchāsamādhi-paccayā
micchāsamādhiṃ=micchā-samādhiṃ
micchāsatipaccayā=micchāsati-paccayā
micchāsatiṃ=micchā-satiṃ
micchāsaṅkappapaccayā=micchā-saṅkappa-paccayā
micchāvimuttiṃ=micchā-vimuttiṃ
micchāvācāpaccayā=micchāvācā-paccayā
micchāvāyāmapaccayā=micchā-vāyāma-paccayā
micchāvāyāmaṃ=micchā-vāyāmaṃ
micchāñāṇamhā=micchā-ñāṇamhā
micchāñāṇapaccayā=micchā-ñāṇa-paccayā
micchāñāṇassa=micchā-ñāṇassa
micchāājīvapaccayā=micchā-ājīva-paccayā
micchāājīvassa=micchā-ājīvassa
micchāājīvena=micchā-ājīvena
midhekaccassa=midha-ekaccassa
midhekaccaṃ=midha-ekaccaṃ
midhekacce=midha-ekacce
midhekacco=midha-ekacco
modatīti=modatī-ti
mohahetukampi=moha-hetukam-pi
mohajañcāpaviddasu=mohajañ-cāpi-viddasu
mohakkhayā=moha-khayā
mohavinayapariyosānavaggo=moha-vinaya-pariyosāna-vaggo
moranivāpakanti=mora-nivāpa-kanti
moranivāpasuttaṃ=mora-nivāpasuttaṃ
mudaggaṃ=mudā-aggaṃ
mukharogo=mukha-rogo
mukhādhānaṃ=mukha-ādhānaṃ
musāvādampāhaṃ=musāvādam-pāhaṃ
musāvādānaṃ=musā-vāda-ānaṃ
muttakarīsena=mutta-karīsena
muṇḍasāvako=muṇḍa-sāvako
muṭṭhasaccaṃ=muṭṭha-saccaṃ
muṭṭhassatiasampajānasandosahetu=muṭṭhassati-asampajāna-sandosahetu
muṭṭhassatissā=muṭṭha-sati-assā
māgataṃ=mā-gataṃ
mālāgandhavilepanadhāraṇamaṇḍanavibhūsanaṭṭhānaṃ=mālā-gandha-vilepana-dhāraṇamaṇḍana-vibhūsana-ṭhānaṃ
mālānānālaṅkārassa=mālā-nānā-alaṅkārassa
mānaganthassa=māna-ganthassa
māradheyyaparānuge=māradheyya-parānuge
mārassāpi=mārassā-pi
mātikāsampannaṃ=mātikā-sampannaṃ
mātugāmassā=mātu-gāmassā
mātugāmenā=mātugāme-nā
mātugāmūpacāro=mātugāma-upacāro
māyimaṃ=mā-imaṃ
māyāpariyuṭṭhitena=māyā-pariyuṭṭhitena
māyāpariyuṭṭhānaṃ=māyā-pariyuṭṭhānaṃ
māyāvinayassa=māyā-vinayassa
mūlakasuttaṃ=mūlaka-suttaṃ
naca=na-ca
naccagītavāditavisūkadassana=nacca-gīta-vādita-visūka-dassana
naccagītavāditavisūkadassanamālāgandhavilepanadhāraṇamaṇḍanavibhūsanaṭṭhānaṃ=naccagītavāditavisūkadassana-mālāgandhavilepanadhāraṇamaṇḍanavibhūsanaṭṭhānaṃ
naccampi=naccam-pi
nahoti=na-hoti
nakulamātāsuttaṃ=nakulamātā-suttaṃ
nalāṭamaṇḍalaṃ=nalāṭa-maṇḍalaṃ
nanahoti=na-nahoti
nandakasuttaṃ=nandaka-suttaṃ
nandimukhiyā=nandi-mukhiyā
nandimukhī=nandi-mukhī
nantakavāsī=nantaka-vāsī
napiyakkosakokāli=na-piya-akkosa-kokāli
nappajānātiparatthampi=nappajānāti-paratthampi
nappajānātiubhayatthampi=na-pajānāti-ubhayattham-pi
nappaṭibhāseyyā=na-paṭibhāseyyā
nappaṭibhātī=na-paṭibhātī
nappaṭibhāyeyya=na-paṭibhāyeyya
nappaṭikkosimhā=na-paṭikkosimhā
nappaṭivirujjhati=na-paṭivirujjhati
nappiyasuttaṃ=nappiya-suttaṃ
nasevitabbādisuttāni=na-asevitabba-ādi-suttāni
natthīti=natthī-ti
navakanipātapāḷi=navaka-nipāta-pāḷi
navamasuttaṃ=navama-suttaṃ
navayime=nava-ime
navayimā=nava-imā
navayimāni=nava-imāni
navaṅguposathasuttaṃ=navaṅga-uposatha-suttaṃ
navuddesā=nava-uddesā
navānukampitassa=navā-anukampi-tassa
navāpi=nava-api
naḷakalāpiyaṃ=naḷa-kalāpiyaṃ
naḷakalāpiyo=naḷa-kalāpiyo
naḷakalāpīnaṃ=naḷa-kalāpīnaṃ
naḷakārā=naḷa-kārā
naḷavaggo=naḷa-vaggo
naḷavanaṃ=naḷa-vanaṃ
naḷerupucimandamūle=naḷeru-pucimanda-mūle
naṭagāmaṇi=naṭa-gāmaṇi
nerayikānaṃ=nerayikā-naṃ
netaṃ=ne-taṃ
nevarūpīnārūpīattāsuttaṃ=nevarūpīnārūpī-attā-suttaṃ
nevasaññānāsaññāyatanampi=nevasaññānāsaññāyatana-mpi
nevasaññānāsaññāyatanampāhaṃ=nevasaññānāsaññāyatana-mpāhaṃ
nevasaññānāsaññāyatanasamāpatti=nevasaññānāsaññāyatana-samāpatti
nevasaññānāsaññāyatanasaññī=nevasaññānāsaññāyatana-saññī
nevāsaṃ=ne-vāsaṃ
nibbidatthaṃ=nibbidā-atthaṃ
nibbidānisaṃsaṃ=nibbidā-nisaṃsaṃ
nibbidāsampannassa=nibbidā-sampannassa
nibbidāvipannassa=nibbidā-vipannassa
nibbidāvirāgatthaṃ=nibbidā-virāgatthaṃ
nibbidāvirāgānisaṃsa=nibbidā-virāgā-nisaṃsa
nibbidāvirāgānisaṃsaṃ=nibbidā-virāgā-nisaṃsaṃ
nibbānasampadaṃ=nibbāna-sampadaṃ
nibbānasukhasuttaṃ=nibbāna-sukhasuttaṃ
niccadānaanukulayaññaṃ=nicca-dāna-anukulayaññaṃ
niddhamanīyasuttaṃ=niddhamanīya-suttaṃ
niddhamathetaṃ=niddhamatha-etaṃ
niddārato=niddā-rato
nidhānakusalo=nidhāna-kusalo
nigghosasaddaṃ=nigghosa-saddaṃ
nijjarasuttaṃ=nijjara-suttaṃ
nikkaṅkhavāhaṃ=nikkaṅkho-vāhaṃ
nikkhagaṇāni=nikkha-gaṇāni
nikāmalābhiniyo=nikāmalābhi-niyo
nimmānaratīdeve=nimmānaratī-deve
nindābyārosanaupārambhabhayā=nindā-byārosana-upārambhabhayā
nindābyārosaupārambhabhayā=nindā-byārosa-upārambhabhayā
nindāghaṭṭanabyārosaupārambhabhayā=nindā-ghaṭṭana-byārosa-upārambhabhayā
nindāpi=nindā-pi
nippapañcarato=nippapañca-rato
nippapañcārāmassāyaṃ=nippapañca-ārāma-sāyaṃ
nippapañcārāmatā=nippapañca-ārāmatā
nippapañcārāmoti=nippapañcārāmo-ti
nipuṇasammatā=nipuṇa-sammatā
nirayasaṃvattanikaṃ=niraya-saṃvattan-ikaṃ
nirayasaṃvattaniko=niraya-saṃvattan-iko
nirayasaṃvattanikā=niraya-saṃvattan-ikā
nirodhasaññāparicitañca=nirodhasaññā-paricitañca
nirodhoti=nirodho-ti
nirāmisāpi=nirāmisā-pi
nirāyattavuttino=nirāyatta-vuttino
nissaraṇadassanahetu=nissaraṇa-dassana-hetu
nissaraṇadassāvī=nissaraṇa-dassāvī
nissaraṇamaddasa=nissaraṇam-addasa
nissaraṇapariyesanaṃ=nissaraṇa-pariyesanaṃ
nissaraṇapañño=nissaraṇa-pañño
nissaraṇapaññā=nissaraṇa-paññā
nissayavaggo=nissaya-vaggo
nisseṇīupamā=nisseṇī-upamā
nisāmakajātiko=nisāmaka-jātiko
nisīditu=nisīdi-tu
niyatāyukā=niyatā-āyukā
niṭṭhaṅgatasuttaṃ=niṭṭhaṅgata-suttaṃ
nocame=no-ca-me
nābhibhuyya=na-abhibhuyya
nābhisambhoti=na-abhisambhoti
nāccogāḷhaṃ=na-accogāḷhaṃ
nāccāsannaṃ=na-accāsannaṃ
nādhibhoti=na-adhibhoti
nāgomhi=na-agomhi
nālabhissa=na-alabhissa
nālamariyasaṅkhātā=nālam-ariya-saṅkhātā
nālamariyā=na-alamariyā
nāmagottāni=nāma-gottāni
nāmarūpārammaṇā=nāmarūpa-ārammaṇā
nānubandhitabbo=na-anubandhitabbo
nānurujjhati=nānu-rujjhati
nānussaritabbañca=nānussari-tabbañ-ca
nānussaritabbo=na-anussaritabbo
nānābhesajjāni=nānā-bhesajjāni
nānādhātuṃ=nānā-dhātuṃ
nānāppakārassa=nānā-pakārassa
nānāvihārehi=nānā-vihārehi
nāpajjati=nā-pajjati
nāsevitabbañca=nāsevi-tabbañ-ca
nāsevitabbo=nā-sevitabbo
nāthavaggo=nātha-vaggo
nātihīnaṃ=nā-ti-hīnaṃ
nīcacittaṃyeva=nīca-cittaṃ-yeva
nīcakulīno=nīca-kulīno
nīcaṭṭhāniyaṃ=nīca-ṭhāniyaṃ
nīlakasiṇasamāpattiparamā=nīla-kasiṇa-samāpatti-paramā
nīvaraṇapabbaṃ=nīvaraṇa-pabbaṃ
nīvaraṇasuttaṃ=nīvaraṇa-suttaṃ
nīvaraṇavaggo=nīvaraṇa-vaggo
nīvaraṇepāhaṃ=nīvaraṇe-pāhaṃ
nīvaraṇākāmā=nīvaraṇā-kāmā
nūname=nūna-me
obhaggobhaggañca=obhaggobhaggañ-ca
obhaggobhaggañcassa=obhaggobhaggañ-cassa
obhaggobhaggaṃ=obhagga-obhaggaṃ
odarikattassetaṃ=odarikattassa-etaṃ
odātakasiṇasamāpattiparamā=odāta-kasiṇa-samāpatti-paramā
ohitasotassa=ohita-sotassa
orimasuttaṃ=orima-suttaṃ
orimatīrasuttaṃ=orima-tīra-suttaṃ
osāretabbāni=osāre-tabbāni
osāritabbāni=osāri-tabbāni
otiṇṇacittā=otiṇṇa-cittā
ovādūpasaṅkamanañca=ovāda-upasaṅkamanañ-ca
oṭṭharogo=oṭṭha-rogo
pabbajitaabhiṇhasuttaṃ=pabbajita-abhiṇha-suttaṃ
pabbajjāsuttaṃ=pabbajjā-suttaṃ
pabbatovābhimaddatī=pabbato-eva-abhimaddatī
pabhāvitameta=pabhāvitam-eta
paccakkhātakakathā=paccakkhātaka-kathā
paccavekkhaṇanimittaṃ=paccavekkhaṇa-nimittaṃ
paccekabuddhaṃ=pacceka-buddhaṃ
pacchābhūmakā=pacchā-bhūmakā
pacchāpetaṃ=pacchā-petaṃ
paccorohaṇivaggo=paccorohaṇi-vaggo
paccuṭṭhānaañjalikamma=paccuṭṭhāna-añjali-kamma
padhānanti=padhāna-nti
padhānasmi=padhāna-asmi
pahānakkhayabbayena=pahāna-khaya-vayena
pahānasaññāparicitañca=pahāna-saññā-paricitañ-ca
pahārādasuttaṃ=pahārāda-suttaṃ
pahīnamevassa=pahīna-me-vassa
pahūtamariyo=pahūtam-ariyo
pajānātiparatthampi=pajānāti-paratthampi
pajānātiubhayatthampi=pajānāti-ubhayattham-pi
pakkamate=pakkama-te
pakkamimhā=pakkama-imhā
pakkhamānattaṃ=pakkha-mānattaṃ
pakkhassāti=pakkhassā-ti
palāsapattānaṃ=palāsa-pattānaṃ
pamāṇakaraṇo=pamāṇa-karaṇo
pamāṇakataṃ=pamāṇa-kataṃ
panassāvusoaññātaṃ=panassa-āvuso-aññātaṃ
panimehi=panime-hi
panāyamāyasmā=panāyamāya-asmā
papañcanirodhe=papañca-nirodhe
papañcārāmatā=papañca-ārāmatā
paracittakusalena=para-citta-kusalena
paracittakusalo=para-citta-kusalo
paracittapariyāyakusalena=paracitta-pariyāya-kusalena
paracittapariyāyakusalo=paracitta-pariyāya-kusalo
paralokampi=paralokam-pi
paralokasaññā=para-loka-saññā
paralokasaññī=para-lokasaññī
paralokavijayāya=paraloka-vijayāya
paramajjadhammesu=parama-ajja-dhammesu
paramatthavisuddhiṃ=paramattha-visuddhiṃ
paramodānaṃ=paramo-dānaṃ
paranimmitavasavattīdeve=paranimmitavasavattī-deve
parapaṭibaddhā=para-paṭibaddhā
parapurāya=para-purāya
paraputtena=para-puttena
parasampattiṃ=para-sampattiṃ
paratoghosapaccayā=parato-ghosa-paccayā
paravipattiṃ=para-vipattiṃ
paribhuñjantānaṃ=paribhuñjantā-naṃ
pariccajā=paricca-jā
parikkamanasuttaṃ=parikkamana-suttaṃ
parikkhārānaṃ=parikkhārā-naṃ
parimaddanabhedana=parimaddana-bhedana
parimaṇḍalaanonamajaṇṇuparimasanalakkhaṇāni=parimaṇḍala-anonama-jaṇṇu-parimasana-lakkhaṇāni
parinibbāyiniyo=parinibbāyin-iyo
paripuṇṇakammantā=paripuṇṇa-kammantā
paripuṇṇakāyo=paripuṇṇa-kāyo
paripuṇṇasaṅkappo=paripuṇṇa-saṅkappo
paripuṇṇasaṅkappā=paripuṇṇa-saṅkappā
paripuṇṇasekho=paripuṇṇa-sekho
parisasārajjabhayassa=parisa-sārajja-bhayassa
parisasārajjabhayaṃ=parisa-sārajja-bhayaṃ
parisuddhaaggappattasārappattakathā=parisuddha-aggappatta-sārappatta-kathā
parisuddhavaggo=parisuddha-vaggo
parisuddhenamhi=parisuddhena-amhi
parisuddhābhānaṃ=parisuddhābha-ānaṃ
parittameko=paritta-me-ko
pariyantadassāvī=pariyanta-dassāvī
pariyeseyya=pariye-seyya
pariyodapanāyā=pariyodapanā-yā
pariyādiṇṇacittassa=pariyādiṇṇa-cittassa
pariyādiṇṇacittaṃ=pariyādiṇṇa-cittaṃ
pariyādiṇṇacitto=pariyādiṇṇa-citto
pariyāyehī=pariyāye-hī
pariññasuttaṃ=pariñña-suttaṃ
pariññatthā=pariñña-atthā
passaddhisampannassa=passaddhi-sampannassa
passaddhisuttaṃ=passaddhi-suttaṃ
passaddhivipannassa=passaddhi-vipannassa
passaddhānisaṃsā=passaddha-ānisaṃsā
passaddhīti=passaddhī-ti
passāmimaṃ=passāmi-maṃ
passāvakammā=passāva-kammā
pathavimpi=pathavim-pi
pathavisaññā=pathavi-saññā
pathavisaññī=pathavi-saññī
pathavābhinandino=pathavī-abhinandino
pathavīkasiṇasamāpattiparamatā=pathavī-kasiṇa-samāpatti-paramatā
pathavīkasiṇasamāpattiparamā=pathavī-kasiṇa-samāpatti-paramā
pathavīsamena=pathavī-samena
patiṭṭhāpeyyapi=patiṭṭhāpeyya-pi
pattakkhandhe=patta-khandhe
pattanikujjanasuttaṃ=patta-nikujjana-suttaṃ
pattappasādena=patta-pasādena
pattasaññī=patta-saññī
pavattamaṃsaṃ=pavatta-maṃsaṃ
pavivekārāmassa=pavivekārāma-assa
pavivittoti=pavivitto-ti
pavuṭasatāni=pavuṭa-satāni
pañcamasuttaṃ=pañcama-suttaṃ
pañcapāhaṃ=pañca-pāhaṃ
pañcasataṃ=pañca-sataṃ
pañcayojanasatikāpi=pañca-yojana-satikā-pi
pañcaṅgasampanno=pañcaṅga-sampanno
pañcaṅgasuttaṃ=pañcaṅga-suttaṃ
pañcaṅgaṃ=pañca-aṅgaṃ
pañcaṅgika=pañca-aṅgika
pañcālacaṇḍasuttaṃ=pañcālacaṇḍa-suttaṃ
pañhādhippāyena=pañha-adhippāyena
paññapethāti=paññapethā-ti
paññattāsane=paññattā-asane
paññāpemā=paññā-pemā
paññāpeyyā=paññā-peyyā
paññāsampannānaṃ=paññā-sampannānaṃ
paññāvimuttasuttaṃ=paññā-vimutta-suttaṃ
paḷāsapariyuṭṭhitena=paḷāsa-pariyuṭṭhitena
paḷāsapariyuṭṭhānaṃ=paḷāsa-pariyuṭṭhānaṃ
paṃsukūlacīvaraṃ=paṃsukūla-cīvaraṃ
paṇihitaacchavaggo=paṇihita-accha-vaggo
paṇītakaṇhasukkasappaṭibhāgānaṃ=paṇīta-kaṇha-sukka-sappaṭibhāgānaṃ
paṇītanti=paṇītan-ti
paṇḍakakathā=paṇḍaka-kathā
paṇḍitavatthūnī=paṇḍita-vatthūnī
paṇṇachattakena=paṇṇa-chattakena
paṇṇakuṭiyo=paṇṇa-kuṭiyo
paṇṇakuṭiyā=paṇṇa-kuṭiyā
paṇṇakuṭīsu=paṇṇa-kuṭīsu
paṇṇasanthare=paṇṇa-santhare
paṇṇasantharo=paṇṇa-santharo
paṭapilotikānaṃ=paṭa-pilotikānaṃ
paṭhamaabhabbaṭṭhānasuttaṃ=paṭhama-abhabba-ṭhāna-suttaṃ
paṭhamaabhisandasuttaṃ=paṭhama-abhisandasuttaṃ
paṭhamaadhammasuttaṃ=paṭhama-adhamma-suttaṃ
paṭhamaagatisuttaṃ=paṭhama-agati-suttaṃ
paṭhamaaggasuttaṃ=paṭhama-agga-suttaṃ
paṭhamaaggisuttaṃ=paṭhama-aggisuttaṃ
paṭhamaagāravasuttaṃ=paṭhama-agārava-suttaṃ
paṭhamaakkhantisuttaṃ=paṭhama-akkhanti-suttaṃ
paṭhamaanuruddhasuttaṃ=paṭhama-anuruddhasuttaṃ
paṭhamaanusayasuttaṃ=paṭhama-anusayasuttaṃ
paṭhamaanāgatabhayasuttaṃ=paṭhama-anāgata-bhayasuttaṃ
paṭhamaanāthapiṇḍikasuttaṃ=paṭhama-anāthapiṇḍikasuttaṃ
paṭhamaanāyussāsuttaṃ=paṭhama-anāyussā-suttaṃ
paṭhamaaparihānasuttaṃ=paṭhama-aparihāna-suttaṃ
paṭhamaaparijānanasuttaṃ=paṭhama-aparijānana-suttaṃ
paṭhamaappiyasuttaṃ=paṭhama-appiya-suttaṃ
paṭhamaaputtakasuttaṃ=paṭhama-aputtaka-suttaṃ
paṭhamaapāsādikasuttaṃ=paṭhama-apāsādika-suttaṃ
paṭhamaarahantasuttaṃ=paṭhama-arahantasuttaṃ
paṭhamaariyāvāsasuttaṃ=paṭhama-ariyā-vāsa-suttaṃ
paṭhamaasappurisasuttaṃ=paṭhama-asappurisa-suttaṃ
paṭhamaasekhasuttaṃ=paṭhama-asekhasuttaṃ
paṭhamaassādapariyesanasuttaṃ=paṭhama-assāda-pariyesana-suttaṃ
paṭhamaassādasuttaṃ=paṭhama-assādasuttaṃ
paṭhamaavaṇṇārahasuttaṃ=paṭhama-avaṇṇārahasuttaṃ
paṭhamaavijjāpahānasuttaṃ=paṭhama-avijjāpahānasuttaṃ
paṭhamaaññatarabhikkhusuttaṃ=paṭhama-aññatarabhikkhusuttaṃ
paṭhamabalasuttaṃ=paṭhama-balasuttaṃ
paṭhamabandhanasuttaṃ=paṭhama-bandhanasuttaṃ
paṭhamadānasuttaṃ=paṭhama-dāna-suttaṃ
paṭhamaejāsuttaṃ=paṭhama-ejā-suttaṃ
paṭhamahatthakasuttaṃ=paṭhama-hatthaka-suttaṃ
paṭhamaiddhipādasuttaṃ=paṭhama-iddhipāda-suttaṃ
paṭhamaidhalokikasuttaṃ=paṭhama-idhalokika-suttaṃ
paṭhamaisidattasuttaṃ=paṭhama-isidatta-suttaṃ
paṭhamakathāvatthusuttaṃ=paṭhama-kathāvatthusuttaṃ
paṭhamakosalasuttaṃ=paṭhama-kosalasuttaṃ
paṭhamalokadhammasuttaṃ=paṭhama-lokadhamma-suttaṃ
paṭhamamahāpañhāsuttaṃ=paṭhama-mahāpañhā-suttaṃ
paṭhamampāhaṃ=paṭhamam-pāhaṃ
paṭhamanaḷakapānasuttaṃ=paṭhama-naḷakapāna-suttaṃ
paṭhamanirayasaggasuttaṃ=paṭhama-nirayasagga-suttaṃ
paṭhamanoceassādasuttaṃ=paṭhama-noceassāda-suttaṃ
paṭhamanāthasuttaṃ=paṭhama-nātha-suttaṃ
paṭhamapaccorohaṇīsuttaṃ=paṭhama-paccorohaṇī-suttaṃ
paṭhamapuggalasuttaṃ=paṭhama-puggalasuttaṃ
paṭhamasaddhāsuttaṃ=paṭhama-saddhāsuttaṃ
paṭhamasañcetanikasuttaṃ=paṭhama-sañcetanika-suttaṃ
paṭhamasukhasuttaṃ=paṭhama-sukhasuttaṃ
paṭhamasuttaṃ=paṭhama-suttaṃ
paṭhamatathāgataacchariyasuttaṃ=paṭhama-tathāgataacchariya-suttaṃ
paṭhamauggasuttaṃ=paṭhama-ugga-suttaṃ
paṭhamaupanisasuttaṃ=paṭhama-upanisa-suttaṃ
paṭhamaupanisāsuttaṃ=paṭhama-upanisā-suttaṃ
paṭhamaupaṭṭhākasuttaṃ=paṭhama-upaṭṭhāka-suttaṃ
paṭhamauppannasuttaṃ=paṭhama-uppanna-suttaṃ
paṭhamauppādasuttaṃ=paṭhama-uppāda-suttaṃ
paṭhamauruvelasuttaṃ=paṭhama-uruvela-suttaṃ
paṭhamaverasuttaṃ=paṭhama-verasuttaṃ
paṭhamavivādamūlasuttaṃ=paṭhama-vivādamūlasuttaṃ
paṭhamaāghātapaṭivinayasuttaṃ=paṭhama-āghātapaṭivinaya-suttaṃ
paṭhamaāhuneyyasuttaṃ=paṭhama-āhuneyya-suttaṃ
paṭhamaājānīyasuttaṃ=paṭhama-ājānīya-suttaṃ
paṭhamaākāsasuttaṃ=paṭhama-ākāsa-suttaṃ
paṭhamaāmakadhaññapeyyālavaggo=paṭhama-āmakadhañña-peyyāla-vaggo
paṭhamaānandasuttaṃ=paṭhama-ānanda-suttaṃ
paṭhamaāyusuttaṃ=paṭhama-āyu-suttaṃ
paṭicchannakammantaṃ=paṭicchanna-kammantaṃ
paṭikūlaanabhiratena=paṭikūla-anabhiratena
paṭimuñcati=paṭimuñca-ti
paṭinissajjitabboti=paṭinissajjitabbo-ti
paṭipadantaguṃ=paṭipada-anta-guṃ
paṭipajjitabbanti=paṭipajji-tabbanti
paṭipajjitu=paṭipajji-tu
paṭippassambheyyā=paṭippa-sambheyyā
paṭisallāṇasuttaṃ=paṭisallāṇa-suttaṃ
paṭisaṅkhānabalā=paṭisaṅkhāna-balā
paṭisāraṇīyasuttaṃ=paṭisāraṇīya-suttaṃ
paṭisāraṇīyañca=paṭisāraṇīyañ-ca
pesuññasuttaṃ=pesuñña-suttaṃ
petehi=pe-tehi
pettivesayikānaṃ=petti-vesayikānaṃ
pettivisayasaṃvattanikaṃ=pettivisaya-saṃvattanikaṃ
pettivisayasaṃvattaniko=pettivisaya-saṃvattaniko
pettivisayasaṃvattanikā=pettivisaya-saṃvattanikā
peyyampi=peyyam-pi
peyyavajjānaṃ=peyya-vajjānaṃ
peyyālaantaramhi=peyyāla-antaramhi
pharusavācampāhaṃ=pharusa-vāca-mpāhaṃ
pharusāvācāpaccayā=pharusāvācā-paccayā
pheṇapiṇḍaṃ=pheṇa-piṇḍaṃ
pheṇapiṇḍe=pheṇa-piṇḍe
phoṭṭhabbabhogā=phoṭṭhabba-bhogā
phoṭṭhabbarasā=phoṭṭhabba-rasā
phoṭṭhabbehī=phoṭṭhabbe-hī
phoṭṭhabbāti=phoṭṭhabbā-ti
phāsuyeva=phāsu-yeva
phāsuṃyeva=phāsuṃ-yeva
phātiseyyaṃ=phāti-seyyaṃ
pisuṇavācampāhaṃ=pisuṇavācam-pāhaṃ
pisuṇavācassa=pisuṇa-vācassa
pisuṇavācaṃ=pisuṇa-vācaṃ
pisuṇavācehi=pisuṇa-vācehi
pisuṇavāco=pisuṇa-vāco
pisuṇavācā=pisuṇa-vācā
pisuṇavācāya=pisuṇa-vācāya
pisuṇāvācāpaccayā=pisuṇāvācā-paccayā
pittasamuṭṭhānā=pitta-samuṭṭhānā
pittasamuṭṭhānānampi=pitta-samuṭṭhānānam-pi
pituaṅke=pitu-aṅke
pitāmaho=pitā-maho
piyagarahī=piya-garahī
piṇḍadāyakā=piṇḍa-dāyakā
piṇḍapātampāhaṃ=piṇḍapātam-pāhaṃ
piṇḍapātasenāsana=piṇḍapāta-senāsana
piṇḍapāte=piṇḍa-pāte
piṇḍapātehi=piṇḍa-pātehi
piṇḍapātā=piṇḍa-pātā
piṇḍasuttaṃ=piṇḍa-suttaṃ
piṇḍiyālopabhojanaṃ=piṇḍiyālopa-bhojanaṃ
piṭakehipi=piṭakehi-pi
piṭṭhisaṃdhovikampi=piṭṭhisaṃdhovikam-pi
pokkharasātiupāsakattapaṭivedanā=pokkharasāti-upāsakatta-paṭivedanā
porisadhammo=porisa-dhammo
potaliputtaavaca=potali-putta-avaca
pubbantamārabbha=pubba-antam-ārabbha
pubbaṅgamasuttaṃ=pubbaṅgama-suttaṃ
pubbekatamanussaraṃ=pubbe-katamanussaraṃ
puggalampāhaṃ=puggalam-pāhaṃ
puggalopi=puggalo-pi
puggalāti=puggalā-ti
punaappamādavaggo=puna-appamādavaggo
punaesanādisuttaṃ=puna-esanādi-suttaṃ
punagaṅgānadīādisuttaṃ=punagaṅgānadī-ādi-suttaṃ
punaoghādisuttaṃ=punaoghādi-suttaṃ
punarāgamāsi=puna-āgamāsi
purapuggalānaṃ=pura-puggalānaṃ
purimasuttantaṃevaṃ=purima-suttantaṃ-evaṃ
purimasuttantetathā=purima-suttante-tathā
purisadose=purisa-dose
purisadoso=purisa-doso
purisadosā=purisa-dosā
purisakhaḷuṅkajhāyitaṃ=purisa-khaḷuṅka-jhāyitaṃ
purisapuggalaparopariye=purisapuggala-paropariye
purisassā=purisa-assā
purisehī=purise-hī
purisādhippāyo=purisa-adhippāyo
purisājānīyassa=purisa-ājānīyassa
purāṇadutiyikā=purāṇa-dutiyikā
purāṇakammaṃ=purāṇa-kammaṃ
purāṇakammo=purāṇa-kammo
purāṇakammā=purāṇa-kammā
purāṇamaggo=purāṇa-maggo
purāṇasabrahmacārī=purāṇa-sabrahmacārī
puthuattadaṇḍā=puthu-atta-daṇḍā
puññabhāgiyaṃ=puñña-bhāgiyaṃ
puññabhāgiyo=puñña-bhāgiyo
puññabhāgiyā=puñña-bhāgiyā
puññadhārā=puñña-dhārā
puññakammā=puñña-kammā
puññakarā=puñña-karā
puññakato=puñña-kato
puññakiriyavatthusuttaṃ=puññakiriya-vatthu-suttaṃ
puññakiriyavatthuṃ=puñña-kiriya-vatthuṃ
puññakiriyavatthūnī=puñña-kiriya-vatthūnī
puññakiriyā=puñña-kiriyā
puññakiriyāsu=puñña-kiriyāsu
puññakiriyāya=puñña-kiriyāya
puññakiriyāyā=puñña-kiriyāyā
puññakāmo=puñña-kāmo
puññakāmā=puñña-kāmā
puññamahī=puñña-mahī
puññapekkhāna=puñña-pekkhāna
puññaphalaṃ=puñña-phalaṃ
puññasammatā=puñña-sammatā
puṇṇamāya=puṇṇa-māya
puṇṇasuttaṃ=puṇṇa-suttaṃ
puṇṇiyasuttaṃ=puṇṇiya-suttaṃ
puṭabhedanaṃ=puṭa-bhedanaṃ
puṭosenā=puṭo-senā
pālemīti=pālemī-ti
pāmojjampāhaṃ=pāmojjam-pāhaṃ
pāmojjasampannassa=pāmojja-sampannassa
pāmojjavipannassa=pāmojja-vipannassa
pāmojjānisaṃso=pāmojja-ānisaṃso
pānakathā=pāna-kathā
pāpabhikkhū=pāpa-bhikkhū
pāpabhūmī=pāpa-bhūmī
pāpadhammaṃ=pāpa-dhammaṃ
pāpamittataṃ=pāpa-mittataṃ
pāpaācāragocare=pāpa-ācāra-gocare
pāpicchataṃ=pāpi-chataṃ
pāpicchatāya=pāpi-chatāya
pāpuṇitu=pāpuṇi-tu
pāraṃgamā=pāraṃ-gamā
pāraṅgāmī=pāraṅ-gāmī
pārājikakathā=pārājika-kathā
pāsaṃsametaṃ=pāsaṃsam-etaṃ
pāsāṇaguḷena=pāsāṇa-guḷena
pāsāṇasakkharikañca=pāsāṇa-sakkharikañ-ca
pāsāṇasakkharā=pāsāṇa-sakkharā
pāsāṇasuttaṃ=pāsāṇa-suttaṃ
pātimokkhaṭṭhapanā=pātimokkha-ṭhapanā
pātimokkhaṭṭhapanāsuttaṃ=pātimokkhaṭṭhapanā-suttaṃ
pāturahosīti=pāturahosī-ti
pāvaḷanipphoṭanāya=pāvaḷa-nipphoṭanāya
pāṇabhūtesu=pāṇa-bhūtesu
pāṇabhūtāni=pāṇa-bhūtāni
pāṇadadiṃ=pāṇa-dadiṃ
pāṇaharā=pāṇa-harā
pāṇaharāhi=pāṇa-harāhi
pāṇaharānaṃ=pāṇa-harānaṃ
pāṇamaduṭṭhacitto=pāṇama-duṭṭhacitto
pāṇasahassāni=pāṇa-sahassāni
pāṇasamā=pāṇa-samā
pāṇasuttaṃ=pāṇa-suttaṃ
pāṇātipātampāhaṃ=pāṇātipātam-pāhaṃ
pāṭikaṅkhitabbānī=pāṭikaṅkhi-tabbānī
pītakasiṇasamāpattiparamā=pīta-kasiṇa-samāpatti-paramā
pītisampannassa=pīti-sampannassa
pītivipannassa=pīti-vipannassa
pīṇindriye=pīṇa-indriye
pīṇindriyā=pīṇa-indriyā
pūtimuttabhesajjaṃ=pūti-mutta-bhesajjaṃ
rajoharaṇasamena=rajo-haraṇa-samena
rajoharaṇaṃ=rajo-haraṇaṃ
rajokiṇṇena=rajo-kiṇṇena
rakkhassetaṃmoggallānavācaṃ=rakkhassetaṃ-moggallāna-vācaṃ
rasabhogā=rasa-bhogā
rathasammaddaṃ=ratha-sammaddaṃ
rathīsaṃyeva=rathīsaṃ-yeva
rattindive=ratti-dive
raññikiṭāgirināmo=raññi-kiṭāgiri-nāmo
raññoānandamahāsudassanassa=rañño-ānanda-mahāsudassanassa
rogajāti=roga-jāti
rukkhamūlasenāsanaṃ=rukkha-mūla-senāsanaṃ
ruṇṇabalā=ruṇṇa-balā
ruṇṇapañcamaṃ=ruṇṇa-pañcamaṃ
ruṇṇasuttaṃ=ruṇṇa-suttaṃ
rādhaanattasuttaṃ=rādha-anattasuttaṃ
rādhaaniccasuttaṃ=rādha-aniccasuttaṃ
rāgavinayapariyosāna=rāga-vinaya-pariyosāna
rājaaparihāniyadhammā=rāja-aparihāniya-dhammā
rājantepura=rāja-ntepura
rājantepurappavesanasuttaṃ=rājantepura-pavesana-suttaṃ
rājantepurappavesane=rājantepura-pavesane
rājaññakulā=rājañña-kulā
rūpaadassanādisuttapañcakaṃ=rūpa-adassana-adi-sutta-pañcakaṃ
rūpaanabhisamayādisuttapañcakaṃ=rūpa-anabhisamaya-adi-sutta-pañcakaṃ
rūpaananubodhādisuttapañcakaṃ=rūpa-ananubodha-adi-sutta-pañcakaṃ
rūpaanupalakkhaṇādisuttapañcakaṃ=rūpa-anupalakkhaṇa-adi-sutta-pañcakaṃ
rūpaappaccakkhakammādisuttacatukkaṃ=rūpa-appaccakkhakamma-adi-sutta-catukkaṃ
rūpaappaccupalakkhaṇādisuttapañcakaṃ=rūpa-appaccupalakkhaṇa-adi-sutta-pañcakaṃ
rūpaappaccupekkhaṇādisuttapañcakaṃ=rūpa-appaccupekkhaṇa-adi-sutta-pañcakaṃ
rūpaappaṭivedhādisuttapañcakaṃ=rūpa-appaṭivedha-adi-sutta-pañcakaṃ
rūpaasallakkhaṇādisuttapañcakaṃ=rūpa-asallakkhaṇa-adi-sutta-pañcakaṃ
rūpaasamapekkhaṇādisuttapañcakaṃ=rūpa-asamapekkhaṇa-adi-sutta-pañcakaṃ
rūpaaññāṇasuttaṃ=rūpa-aññāṇa-suttaṃ
rūpabhavāyā=rūpa-bhavāyā
rūpabhogā=rūpa-bhogā
rūparasā=rūpa-rasā
rūpasaddagandharasaphoṭṭhabbāni=rūpa-sadda-gandha-rasa-phoṭṭhabbāni
rūpiyapātisahassāni=rūpiya-pātisahassāni
rūpiyapūrāni=rūpiya-pūrāni
rūpānañca=rūpānañ-ca
rūpīattāsuttaṃ=rūpī-attā-suttaṃ
rūpīcaarūpīcaattāsuttaṃ=rūpīca-arūpīcaattā-suttaṃ
sabbaabbhantarimaṃ=sabba-abbhantarimaṃ
sabbaahaṃkāramamaṃkāramānānusayānaṃ=sabba-ahaṃkārama-maṃkāra-mānānusayānaṃ
sabbaaniccavaggo=sabba-aniccavaggo
sabbabhūtānaṃ=sabba-bhūtānaṃ
sabbadukkhehi=sabba-dukkhehi
sabbakāmadaṃ=sabba-kāmadaṃ
sabbalahuso=sabba-lahuso
sabbalokeanabhiratisaññā=sabbaloke-anabhiratisaññā
sabbapāṇabhūtahitānukampino=sabba-pāṇa-bhūta-hita-anukampi-no
sabbapāṇabhūtesu=sabba-pāṇa-bhūtesu
sabbasampadā=sabba-sampadā
sabbasova=sabba-sova
sabbasāmukkaṃsikaṃ=sabba-sāmukkaṃsikaṃ
sabbenapi=sabbena-pi
sabbesveva=sabbe-sveva
sabbopi=sabbo-pi
sabbākāraparipūro=sabbā-kāra-paripūro
sabbūpadhippaṭinissaggo=sabba-upadhi-paṭinissaggo
sabhaggato=sabha-gato
sacajja=sacajja
sacassa=sacassa
saccanāmena=sacca-nāmena
saccavādiniṃ=sacca-vādiniṃ
sacchikātabbasuttaṃ=sacchikātabba-suttaṃ
sacchikātabbañca=sacchikā-tabbañca
sacittapariyāyakusalo=sacitta-pariyāya-kusalo
sacittasuttaṃ=sacitta-suttaṃ
sacittavaggo=sacitta-vaggo
sacittañca=sacittañ-ca
saddabhogā=sadda-bhogā
saddakaṇṭakā=sadda-kaṇṭakā
saddarasā=sadda-rasā
saddhammaaparihānaṃ=saddhamma-aparihānaṃ
saddhammassavana=saddhammassa-vana
saddhammassavanampāhaṃ=saddhamma-savanam-pāhaṃ
saddhammassavanassa=saddhammassa-vanassa
saddhammassavane=saddhammassa-vane
saddhammañca=saddhammañ-ca
saddhābala=saddhā-bala
saddhāpadānaṃ=saddhā-padānaṃ
saddhāpadānesu=saddhā-padānesu
saddhāpadānesū=saddha-apadānesū
saddhāpadānāni=saddhā-padānāni
saddhāsampannā=saddhā-sampannā
saddhāsampannānaṃ=saddhā-sampannānaṃ
sadevakopi=sadevako-pi
sahampatiyācaṃ=sahampati-yācaṃ
sahetuanattasuttaṃ=sahetu-anattasuttaṃ
sahetuaniccasuttaṃ=sahetu-aniccasuttaṃ
sajjhasuttaṃ=sajjha-suttaṃ
sajjhāyakiriyā=sajjhāya-kiriyā
sakadāgāmipatto=sakadāgāmi-patto
sakadāgāmisatto=sakadāgāmi-satto
sakadāgāmitāya=sakadāgāmitā-ya
sakalikaggissa=sakalikagga-issa
sakaṭamukhaṃ=sakaṭa-mukhaṃ
sakaṭamukhāni=sakaṭa-mukhāni
sakaṭasahassaṃ=sakaṭa-sahassaṃ
sakaṭasatthassa=sakaṭa-satthassa
sakaṭasatānaṃ=sakaṭa-satānaṃ
sakaṭasatāni=sakaṭa-satāni
sakaṭasatānī=sakaṭa-satānī
sakiṃdeva=sakiṃ-deva
sakkaccaṃyeva=sakkaccaṃ-yeva
sakuṇajāti=sakuṇa-jāti
sakuṇavijjā=sakuṇa-vijjā
sakyaputtiyāna=sakya-puttiya-āna
sallañca=sallañ-ca
samagganandiṃ=samagga-nandiṃ
samaggānañca=samaggānañ-ca
samajīvitā=sama-jīvitā
samantapāsādiko=samanta-pāsādiko
samanupassantī=sama-anupassantī
samapākāni=sama-pākāni
samathasuttaṃ=samatha-suttaṃ
samathenaṭṭhame=samathena-aṭṭhame
samatikkamatha=sam-atikkamatha
samañca=samañ-ca
samaṅgībhūte=samaṅgī-bhūte
samaṇabhāvena=samaṇa-bhāvena
samaṇabrāhmaṇaparibbājakā=samaṇa-brāhmaṇa-paribbājakā
samaṇabrāhmaṇasuttaṃ=samaṇa-brāhmaṇa-suttaṃ
samaṇabrāhmaṇavaggo=samaṇa-brāhmaṇa-vaggo
samaṇabrāhmaṇe=samaṇa-brāhmaṇe
samaṇabrāhmaṇehi=samaṇa-brāhmaṇehi
samaṇabrāhmaṇesu=samaṇa-brāhmaṇesu
samaṇabrāhmaṇā=samaṇa-brāhmaṇā
samaṇabrāhmaṇānaṃ=samaṇa-brāhmaṇānaṃ
samaṇadhamma=samaṇa-dhamma
samaṇadhamme=samaṇa-dhamme
samaṇadosānaṃ=samaṇa-dosānaṃ
samaṇadukkhāni=samaṇa-dukkhāni
samaṇadūsīvāyaṃ=samaṇa-dūsīvāyaṃ
samaṇagāravaṃ=samaṇa-gāravaṃ
samaṇajātikā=samaṇa-jātikā
samaṇakaraṇā=samaṇa-karaṇā
samaṇakaraṇīyāni=samaṇa-karaṇīyāni
samaṇakasaṭānaṃ=samaṇa-kasaṭānaṃ
samaṇakāraṇḍavo=samaṇa-kāraṇḍavo
samaṇamalānaṃ=samaṇa-malānaṃ
samaṇamaṇḍalassa=samaṇa-maṇḍalassa
samaṇamhāti=samaṇā-amhā-ti
samaṇamānine=samaṇa-mānine
samaṇapadumo=samaṇa-padumo
samaṇapalāpo=samaṇa-palāpo
samaṇaparisaṃ=samaṇa-parisaṃ
samaṇaparisā=samaṇa-parisā
samaṇapasādaṃ=samaṇa-pasādaṃ
samaṇapaṇḍite=samaṇa-paṇḍite
samaṇapaṭiññassa=samaṇa-paṭiññassa
samaṇapaṭiññaṃ=samaṇa-paṭiññaṃ
samaṇapaṭiñño=samaṇa-paṭiñño
samaṇapemaṃ=samaṇa-pemaṃ
samaṇapuṇḍarīko=samaṇa-puṇḍarīko
samaṇasammatā=samaṇa-sammatā
samaṇasaññā=samaṇa-saññā
samaṇasaññāsuttaṃ=samaṇasaññā-suttaṃ
samaṇasaññāvaggo=samaṇa-saññāvaggo
samaṇasaṅghassa=samaṇa-saṅghassa
samaṇasukhumālo=samaṇa-sukhumālo
samaṇasukhāni=samaṇa-sukhāni
samaṇasuttaṃ=samaṇa-suttaṃ
samaṇavaggo=samaṇa-vaggo
samaṇavādo=samaṇa-vādo
samaṇāmhāti=samaṇāmhā-ti
sambhejjaudakasuttaṃ=sambhejjaudaka-suttaṃ
sambodhipakkhikānaṃ=sambodhi-pakkhikānaṃ
sambodhisuttaṃ=sambodhi-suttaṃ
sambodhivaggo=sambodhi-vaggo
sambodhiyaṅgesu=sambodhiya-aṅgesu
sambādhasuttaṃ=sambādha-suttaṃ
sammapaññāya=samma-paññāya
sammappadhānavaggo=sammappadhāna-vaggo
sammappajānāti=samma-pajānāti
sammatenapi=sammatena-pi
sammukhībhūtaṃ=sammukhī-bhūtaṃ
sammākammantapaccayā=sammā-kammanta-paccayā
sammāsamādhipaccayā=sammāsamādhi-paccayā
sammāsatipaccayā=sammāsati-paccayā
sammāsaṅkappapaccayā=sammā-saṅkappa-paccayā
sammāvattanasuttaṃ=sammā-vattana-suttaṃ
sammāvācāpaccayā=sammāvācā-paccayā
sammāvāyāmapaccayā=sammā-vāyāma-paccayā
sammāñāṇapaccayā=sammā-ñāṇa-paccayā
sammāñāṇissa=sammā-ñāṇissa
sammāājīvapaccayā=sammā-ājīva-paccayā
sammāājīvassa=sammā-ājīvassa
sampajjatipi=sampajjati-pi
sampajjatiyeva=sampajjati-yeva
sampannamānaso=sampanna-mānaso
sampannapaññe=sampanna-paññe
sampannasīlesu=sampanna-sīlesu
samparāyahitāya=samparāya-hitāya
samparāyasukhāyā=samparāya-sukhāyā
samphabhāsena=sampha-bhāsena
samphappalāpampāhaṃ=samphappalāpam-pāhaṃ
sampāpuṇitu=sampāpuṇi-tu
samudāgacchantī=samudā-gacchantī
samuggatassa=samuggata-assa
samādhiandhakavindaṃ=samādhi-andhakavindaṃ
samādhijapītisukhassādavinibandhaṃ=samādhija-pīti-sukha-assāda-vinibandhaṃ
samādhimūlakaabhinīhārasuttaṃ=samādhi-mūlaka-abhinīhāra-suttaṃ
samādhimūlakaārammaṇasuttaṃ=samādhimūlaka-ārammaṇa-suttaṃ
samādhināti=samādhinā-ti
samādhippamukhā=samādhi-pamukhā
samādhānisaṃsa=samādhi-ānisaṃsa
samādhānisaṃsaṃ=samādhi-ānisaṃsaṃ
samāditabbanti=samādi-tabbanti
samāhitoti=samāhito-ti
samāpajjimpi=samāpajjim-pi
samāpajjāmipi=samāpajjāmi-pi
samāpannapubbā=samāpanna-pubbā
samāpattikusalehi=samāpatti-kusalehi
samāpattikusalena=samāpatti-kusalena
samāpattimūlakaabhinīhārasuttaṃ=samāpatti-mūlaka-abhinīhāra-suttaṃ
samāpattimūlakaārammaṇasuttaṃ=samāpatti-mūlaka-ārammaṇa-suttaṃ
samāpattivuṭṭhānakusalehi=samāpatti-vuṭṭhāna-kusalehi
sandacchāyo=sanda-chāyo
sandiṭṭhikadhammasuttaṃ=sandiṭṭhika-dhamma-suttaṃ
sandiṭṭhikanibbānasuttaṃ=sandiṭṭhika-nibbānasuttaṃ
sandiṭṭhiparāmāsi=sandiṭṭhi-parāmāsi
sandiṭṭhiparāmāsā=sandiṭṭhi-parāmāsā
sannivutthapubbanti=sannivuttha-pubbanti
sannivutthapubbaṃ=sannivuttha-pubbaṃ
santattaayoguḷaupamā=santatta-ayo-guḷa-upamā
santavimokkhasuttaṃ=santa-vimokkha-suttaṃ
santavāco=santa-vāco
santeyeva=sante-yeva
santuṭṭhoti=santuṭṭho-ti
sapattaverasaṃvattaniko=sapatta-vera-saṃvattaniko
sappahaṃseti=sappa-ahaṃ-seti
sappaññajātiko=sappañña-jātiko
sappaññavaggo=sappañña-vaggo
sappaṭikammāpattīti=sappaṭikammā-pattī-ti
sappitelanavanītena=sappitela-navanītena
sappurisadhammasuttaṃ=sappurisa-dhamma-suttaṃ
sappurisānuyātā=sappurisa-anuyātā
sappāyakiriyā=sappāya-kiriyā
sarapattappahārānaṃ=sara-patta-pahārānaṃ
saravegehi=sara-vegehi
saravegena=sara-vegena
saraṇagamanaṃ=saraṇa-gamanaṃ
saraṇagamanehi=saraṇa-gamanehi
sarāgaahirājā=sarāga-ahi-rājā
sarīraṭṭhadhammasuttaṃ=sarīraṭṭhadhamma-suttaṃ
sasaṅkhāraparinibbāyissa=sasaṅkhāra-parinibbāyissa
sassamaṇabrāhmaṇiyā=sassamaṇa-brāhmaṇiyā
sassamaṇabrāhmaṇiṃ=sassamaṇa-brāhmaṇiṃ
sassamaṇabrāhmaṇī=sassamaṇa-brāhmaṇī
sassataloko=sassata-loko
satipaṭṭhānavagge=satipaṭṭhāna-vagge
satipaṭṭhānavaggo=satipaṭṭhāna-vaggo
satipaṭṭhānaṃevaṃ=satipaṭṭhānaṃ-evaṃ
satipuṇṇiyamūlena=satipuṇṇiya-mūlena
satisampajañña=sati-sampajañña
satisampajaññampāhaṃ=sati-sampajaññam-pāhaṃ
satisampajaññasampannassa=sati-sampajañña-sampannassa
satisampajaññasmiṃ=sati-sampajaññasmiṃ
satisampajaññasuttaṃ=satisampajañña-suttaṃ
satisampajaññavipannassa=sati-sampajañña-vipannassa
satisampajaññe=sati-sampajaññe
sativaggo=sati-vaggo
sattakkhattuparamassa=sattakkhattu-paramassa
sattamasuttaṃ=sattama-suttaṃ
sattapaññā=satta-paññā
sattapāhaṃ=satta-pāhaṃ
sattaratano=satta-ratano
sattasaṇḍaṃ=satta-saṇḍaṃ
satthasamphasso=sattha-samphasso
satthavāhaupamā=satthavāha-upamā
satthādāna=satthā-dāna
satthādānaṃ=satthā-dānaṃ
sattuddesā=satta-uddesā
sattāvāsasuttaṃ=sattā-vāsa-suttaṃ
sattāvāsavaggo=sattāvāsa-vaggo
sattāvāsesu=sattā-vāse-su
satādhipateyyā=sata-adhipateyyā
saupanise=sa-upanise
saupādisesasuttaṃ=saupādisesa-suttaṃ
saupādānassā=sa-upādānassā
sauttaranti=sa-uttaranti
savanampāhaṃ=savanam-pāhaṃ
savitakkaavicārā=savitakka-avicārā
savitakkasavicārampi=savitakka-savicāram-pi
sañjīvoteva=sañjīvo-teva
saññāattakathā=saññā-atta-kathā
saññāaññāṇasuttaṃ=saññā-aññāṇa-suttaṃ
saññāvedayitanirodhampāhaṃ=saññāvedayita-nirodha-mpāhaṃ
saññāvedayitanirodhe=saññāvedayita-nirodhe
saññāvedayitanirodho=saññāvedayita-nirodho
saṃbhejjaudaka=saṃbhejja-udaka
saṃghampi=saṃgham-pi
saṃkiṇṇaparikho=saṃkiṇṇa-parikho
saṃkiṇṇaparikkho=saṃkiṇṇa-parikkho
saṃsaggārāmatā=saṃsagga-ārāmatā
saṃsappajātikā=saṃsappa-jātikā
saṃsappanīyapariyāyaṃ=saṃsappanīya-pariyāyaṃ
saṃsappanīyapariyāyo=saṃsappanīya-pariyāyo
saṃsappanīyasuttaṃ=saṃsappanīya-suttaṃ
saṃvaṭṭavivaṭṭaṃ=saṃvaṭṭa-vivaṭṭaṃ
saṃvaṭṭavivaṭṭāni=saṃvaṭṭa-vivaṭṭāni
saṃyatattamāgataṃ=saṃyata-attam-āgataṃ
saṃyojanākhilena=saṃyojanā-khilena
saṅgahitaparijano=saṅgahita-parijano
saṅgaṇikavihāraṃ=saṅgaṇika-vihāraṃ
saṅgaṇikārāmassā=saṅgaṇika-ārāmassā
saṅghabhedako=saṅgha-bhedako
saṅghabhedasuttaṃ=saṅgha-bheda-suttaṃ
saṅghabhedo=saṅgha-bhedo
saṅghasammuti=saṅgha-sammuti
saṅghasāmaggī=saṅgha-sāmaggī
saṅghasāmaggīsuttaṃ=saṅghasāmaggī-suttaṃ
saṅgāhabalaṃ=saṅgāha-balaṃ
saṅgāhakā=saṅgāha-kā
saṅkappamaññāya=saṅkappa-maññāya
saṅkappavitakkā=saṅkappa-vitakkā
saṅkassarasamācāraṃ=saṅkassara-samācāraṃ
saṅkhadhamaupamā=saṅkha-dhama-upamā
saṅkhalikāhī=saṅkhalikā-hī
saṅkhayaṃ=saṅkha-yaṃ
saṅkhittūposathasuttaṃ=saṅkhittūposatha-suttaṃ
saṅkhāraaññāṇasuttaṃ=saṅkhāra-aññāṇa-suttaṃ
saṇḍasaṇḍacārinī=saṇḍa-saṇḍa-cārinī
semhasamuṭṭhānā=semha-samuṭṭhānā
semhasamuṭṭhānānampi=semha-samuṭṭhānānam-pi
senāpatinā=senāpati-nā
senāsana=sena-āsana
senāsanagilānappaccaya=senāsana-gilānappaccaya
senāsanagilānappaccayabhesajjaparikkhārānaṃ=senāsana-gilānappaccayabhesajjaparikkhārānaṃ
senāsanampi=senāsanam-pi
senāsanampāhaṃ=senāsanam-pāhaṃ
senāsanasuttaṃ=senāsana-suttaṃ
senāsanañca=senāsanañ-ca
sevanāsuttaṃ=sevanā-suttaṃ
sevitabbopi=sevitabbo-pi
sevīti=sevī-ti
seyyathāpiṇa=seyyathāpi-ṇa
sikkhare=sikkha-re
sikkhasuttaṃ=sikkha-suttaṃ
sikkhitasikkhāya=sikkhita-sikkhāya
sikkhādubbalyasuttaṃ=sikkhā-dubbalya-suttaṃ
sikkhādubbalyānaṃ=sikkhā-dubbalyānaṃ
sikkhādubbalyāni=sikkhā-dubbalyāni
sikkhāsuttādipeyyālaekādasakaṃ=sikkhā-suttā-dipeyyāla-ekādasakaṃ
silāyupo=silā-yupo
silāyūpasuttaṃ=silāyūpa-suttaṃ
siṅgīsuvaṇṇaṃ=siṅgī-suvaṇṇaṃ
soattā=so-attā
soattāsuttaṃ=so-attā-suttaṃ
sobhanakaṃ=sobhana-kaṃ
sokasabhaye=soka-sabhaye
sopassa=so-passa
sovaṇṇadhajāni=sovaṇṇa-dhajāni
sovaṇṇamayassa=sovaṇṇa-mayassa
sovaṇṇamayaṃ=sovaṇṇa-mayaṃ
sovaṇṇamaye=sovaṇṇa-maye
sovaṇṇamayo=sovaṇṇa-mayo
sovaṇṇamayā=sovaṇṇa-mayā
sovaṇṇamayāni=sovaṇṇa-mayāni
sovaṇṇamayāya=sovaṇṇa-mayāya
soḷasakukkuko=soḷasa-kukkuko
soḷasākārasampannā=soḷasā-kāra-sampannā
soṇadaṇḍaguṇakathā=soṇadaṇḍa-guṇa-kathā
soṇadaṇḍaparivitakko=soṇadaṇḍa-parivitakko
soṇadaṇḍasuttaṃ=soṇadaṇḍa-suttaṃ
soṇadaṇḍaupāsakattapaṭivedanā=soṇadaṇḍa-upāsakatta-paṭivedanā
soṇasiṅgālā=soṇa-siṅgālā
soṇasuttaṃ=soṇa-suttaṃ
subhanimittānuyogo=subha-nimittā-anuyogo
subhāvitacitto=subhāvita-citto
subhāvitānī=subhā-vitānī
subhūme=su-bhūme
subhūtisuttaṃ=subhūti-suttaṃ
sucikaraṇā=suci-karaṇā
sucissa=sucissa
suciyeva=suci-yeva
sucīyeva=sucī-yeva
suddhāsuddhehi=suddha-asuddhehi
suhuṭṭhitaṃ=su-uṭṭhitaṃ
sukasāḷika=suka-sāḷika
sukaṭadukkaṭānaṃ=sukaṭa-dukkaṭānaṃ
sukhado=sukha-do
sukhamidaṃ=sukham-idaṃ
sukhasampannassa=sukha-sampannassa
sukhavipannassa=sukha-vipannassa
sukhavipākañca=sukhavipākañ-ca
sukhudrayañca=sukha-udrayañ-ca
sukhudrayo=sukha-udrayo
sukhānisaṃsā=sukha-ānisaṃsā
sukkamaggañca=sukka-maggañca
sukkamaggo=sukka-maggo
sunettaarakena=sunetta-arakena
supassaṃ=su-passaṃ
supaṇṇasaṃyuttaṃ=supaṇṇa-saṃyuttaṃ
supaṇṇayoniyo=supaṇṇa-yoniyo
supinakaupamā=supinaka-upamā
surādhutto=surā-dhutto
surāmado=surā-mado
surāmerayapānaṃ=surāmeraya-pānaṃ
susaṃvihitakammanto=susaṃvihita-kammanto
susukāḷakesā=susukāḷa-kesā
susīlyamattano=susīlyam-attano
sutavatopi=sutavato-pi
sutavāsuttaṃ=sutavā-suttaṃ
suttasahassāni=sutta-sahassāni
suvaṇṇabhiṅkāraṃ=suvaṇṇa-bhiṅkāraṃ
suvaṇṇabhāraṃ=suvaṇṇa-bhāraṃ
suvaṇṇachanno=suvaṇṇa-channo
suvaṇṇacuṇṇaparipūrāya=suvaṇṇa-cuṇṇa-paripūrāya
suvaṇṇadubbaṇṇāni=suvaṇṇa-dubbaṇṇāni
suvaṇṇakāro=suvaṇṇa-kāro
suvaṇṇamālāya=suvaṇṇa-mālāya
suvaṇṇanikkhasuttādiaṭṭhakaṃ=suvaṇṇa-nikkha-sutta-adi-aṭṭhakaṃ
suvaṇṇanikkhaṃ=suvaṇṇa-nikkhaṃ
suvaṇṇanikkho=suvaṇṇa-nikkho
suvaṇṇapātisahassāni=suvaṇṇa-pātisahassāni
suvaṇṇapūrāni=suvaṇṇa-pūrāni
suvaṇṇavaṇṇalakkhaṇaṃ=suvaṇṇavaṇṇa-lakkhaṇaṃ
suvaṇṇavaṇṇaṃ=suvaṇṇa-vaṇṇaṃ
suvaṇṇavaṇṇo=suvaṇṇa-vaṇṇo
suvaṇṇavikatiṃ=suvaṇṇa-vikatiṃ
suññagehāni=suñña-gehāni
suññavane=suñña-vane
sādhuvaggo=sādhu-vaggo
sādhuñca=sādhuñ-ca
sādhāraṇabhogī=sādhāraṇa-bhogī
sākhābhaṅgena=sākhā-bhaṅgena
sālikkhette=sāli-khette
sāmaññagato=sāmañña-gato
sāmaññaphala=sāmañña-phala
sāmaññaphalaṃ=sāmañña-phalaṃ
sāmaññaphalehi=sāmañña-phalehi
sāmaññaphalā=sāmañña-phalā
sāmaññaphalāni=sāmañña-phalāni
sāmaññaphalānī=sāmañña-phalānī
sāmaññasambhūtāni=sāmañña-sambhūtāni
sāmaññasaṅkhātā=sāmañña-saṅkhātā
sāmaññasuttaṃ=sāmañña-suttaṃ
sāmaññavaggo=sāmañña-vaggo
sāmīcikammacīvarapiṇḍapātasenāsanagilānappaccayabhesajjaparikkhārānuppadānena=sāmīcikamma-cīvarapiṇḍapātasenāsanagilānappaccayabhesajja-parikkhāra-anuppadānena
sāraddhakāyo=sāraddha-kāyo
sārajjamānarūpaṃ=sārajjamāna-rūpaṃ
sārajjamānarūpo=sārajjamāna-rūpo
sāsavasuttaṃ=sāsava-suttaṃ
sāsavañca=sāsavañ-ca
sātarūpena=sāta-rūpena
sāvajjakāyakammantavacīkammantamanokammanto=sāvajja-kāyakammanta-vacīkammanta-manokammanto
sāvajjañca=sāvajjañ-ca
sāvasesāpattīti=sāvasesāpattī-ti
sāvasā=sā-vasā
sāyanīyāni=sāyanīya-āni
sāyatatiyakaṃ=sāya-tatiyakaṃ
sāṇabhāraṃ=sāṇa-bhāraṃ
sāṇabhārikaupamā=sāṇa-bhārika-upamā
sāṇabhāro=sāṇa-bhāro
sāṇasuttaṃ=sāṇa-suttaṃ
sāṭheyyapariyuṭṭhitena=sāṭheyya-pariyuṭṭhitena
sāṭheyyapariyuṭṭhānaṃ=sāṭheyya-pariyuṭṭhānaṃ
sāṭheyyavinayassa=sāṭheyya-vinayassa
sīhanāde=sīha-nāde
sīhādhivutti=sīha-adhivutti
sīlasampannānaṃ=sīla-sampannānaṃ
sīlavantaānisaṃsā=sīlavanta-ānisaṃsā
sīsarogo=sīsa-rogo
sīvakaaṭṭhasataṃ=sīvaka-aṭṭhasataṃ
tadabhiññāsi=tadabhiññā-si
tadahūpasampannassa=tadaha-upasampannassa
tadaṅgadiṭṭhadhammikena=tadaṅga-diṭṭhadhammikena
tadaṅganibbāna=tadaṅga-nibbāna
tadaṅganibbānasuttaṃ=tadaṅganibbāna-suttaṃ
tadaṅganibbānaṃ=tadaṅga-nibbānaṃ
tadubhayampi=tadubhayam-pi
tapanīyañca=tapanīyañ-ca
tapanīyāhaṃ=tapanīya-ahaṃ
tapojigucchāallīnā=tapojigucchā-allīnā
taruṇapabbajito=taruṇa-pabbajito
taruṇavacchaṃ=taruṇa-vacchaṃ
taruṇavacchā=taruṇa-vacchā
tassapāpiyasikakammakatena=tassapāpiyasika-kamma-katena
tathāgataṃtadapi=tathāgataṃ-tadapi
tathāhimaṃ=tathāhi-maṃ
tathārūpāyaṃbhikkhaveparisā=tathārūpāyaṃ-bhikkhave-parisā
tatiyaabhabbaṭṭhānasuttaṃ=tatiya-abhabba-ṭhāna-suttaṃ
tatiyaabhisandasuttaṃ=tatiya-abhisandasuttaṃ
tatiyaadhammasuttaṃ=tatiya-adhamma-suttaṃ
tatiyaagatisuttaṃ=tatiya-agati-suttaṃ
tatiyaanattasuttaṃ=tatiya-anattasuttaṃ
tatiyaaniccasuttaṃ=tatiya-aniccasuttaṃ
tatiyaanudhammasuttaṃ=tatiya-anudhammasuttaṃ
tatiyaanāgatabhayasuttaṃ=tatiya-anāgata-bhayasuttaṃ
tatiyaassādasuttaṃ=tatiya-assādasuttaṃ
tatiyaavaṇṇārahasuttaṃ=tatiya-avaṇṇārahasuttaṃ
tatiyampāhaṃ=tatiyam-pāhaṃ
tatiyaovādasuttaṃ=tatiya-ovāda-suttaṃ
tatiyasuttaṃ=tatiya-suttaṃ
tatiyaupanisasuttaṃ=tatiya-upanisa-suttaṃ
tatiyaupanisāsuttaṃ=tatiya-upanisā-suttaṃ
tatiyauposathasuttaṃ=tatiya-uposatha-suttaṃ
tatiyaājānīyasuttaṃ=tatiya-ājānīya-suttaṃ
tatiyaāmakadhaññapeyyālavaggo=tatiya-āmakadhañña-peyyāla-vaggo
tatthūpapannā=tattha-upapannā
tayodhammasuttaṃ=tayodhamma-suttaṃ
tayāvetaṃ=tayā-evetaṃ
tañcāpi=tañcā-pi
taṃsaññāparicitañca=taṃ-saññā-paricitañ-ca
taṇhāmūlakasuttaṃ=taṇhā-mūlaka-suttaṃ
taṇhāmūlake=taṇhā-mūlake
tejokasiṇasamāpattiparamā=tejo-kasiṇa-samāpatti-paramā
tejosamena=tejo-samena
tejosaññā=tejo-saññā
tejosaññī=tejo-saññī
temārisa=te-mārisa
tenupasaṅkamimhā=tena-upasaṅkami-mhā
tesaṃye=tesaṃ-ye
tevijjā=te-vi-jjā
therānukampitassa=therā-anukampi-tassa
therāpi=therā-pi
thinamiddhapariyuṭṭhito=thinamiddha-pariyuṭṭhito
thinamiddhapariyuṭṭhānaṃ=thinamiddha-pariyuṭṭhānaṃ
thinamiddho=thina-middho
thāmase=thāma-se
thāmaso=thāma-so
tibhāgo=ti-bhāgo
tidaṃ=ti-idaṃ
tidaṇḍaṃ=ti-daṇḍaṃ
tikaṇṇasuttaṃ=tikaṇṇa-suttaṃ
tikicchakasuttaṃ=tikicchaka-suttaṃ
timbarukā=timbaru-kā
tiracchānayonikā=tiracchāna-yonikā
tiracchānayonikānaṃ=tiracchāna-yonikānaṃ
tiracchānayonisaṃvattanikaṃ=tiracchānayoni-saṃvattanikaṃ
tiracchānayonisaṃvattaniko=tiracchānayoni-saṃvattaniko
tiracchānayonisaṃvattanikā=tiracchānayoni-saṃvattanikā
tittakālābubījaṃ=tittakālābu-bījaṃ
tividha=ti-vidha
tividhakāyakammantasampattikusalasañcetanikāhetu=tividha-kāya-kammanta-sampatti-kusala-sañcetanikā-hetu
tividhakāyakammantasandosabyāpatti=tividha-kāya-kammanta-sandosa-byāpatti
tividhamanokammantasampattikusalasañcetanikāhetu=tividha-manokammantasampatti-kusalasañcetanikā-hetu
tividhamanokammantasandosabyāpatti=tividha-manokammantasandosabyāpatti
tiyojana=ti-yojana
tiyojanasatikāpi=ti-yojana-satikā-pi
tiṇabhakkho=tiṇa-bhakkho
tiṇabhakkhā=tiṇa-bhakkhā
tiṇadāye=tiṇa-dāye
tiṇagahanaṃ=tiṇa-gahanaṃ
tiṇagahanā=tiṇa-gahanā
tiṇahārakaṃ=tiṇa-hārakaṃ
tiṇajāti=tiṇa-jāti
tiṇakalāpaṃ=tiṇa-kalāpaṃ
tiṇapurisarūpake=tiṇapurisa-rūpake
tiṇapuñjaṃ=tiṇa-puñjaṃ
tiṇapuñje=tiṇa-puñje
tiṇasanthārakasayanāsanaṃ=tiṇa-santhāraka-sayanāsanaṃ
tiṇasanthārakaṃ=tiṇa-santhārakaṃ
tiṇasanthārake=tiṇa-santhārake
tiṇasanthārako=tiṇa-santhārako
tiṇḍukamattiyo=tiṇḍuka-mattiyo
tiṇṇavicchikicchā=tiṇṇa-vicchikicchā
tiṇṇavicikicchataṃ=tiṇṇa-vicikicchataṃ
tiṇṇavicikicchatā=tiṇṇa-vicikicchatā
tiṇṇavicikicchaṃ=tiṇṇa-vicikicchaṃ
tiṇṇavicikiccho=tiṇṇa-vicikiccho
tiṇṇavicikicchā=tiṇṇa-vicikicchā
tiṭhānaṃ=ti-ṭhānaṃ
tulādhārantevāsī=tulādhāra-antevāsī
tulādhāro=tulā-dhāro
tālapuṭasuttaṃ=tālapuṭa-suttaṃ
tāvatiṃsadevaupamā=tāvatiṃsadeva-upamā
tīṇipāhaṃ=tīṇi-pāhaṃ
ubbāhikāsuttaṃ=ubbāhikā-suttaṃ
ubhatobhāgavimuttasuttaṃ=ubhato-bhāga-vimutta-suttaṃ
ubhatobhāgo=ubhato-bhāgo
uccaṭṭhāniyaṃ=uccaṭṭhāna-iyaṃ
ucchaṅgehipi=ucchaṅgehi-pi
uccāretu=uccā-re-tu
udakabubbuḷūpamaṃ=udaka-bubbuḷa-upamaṃ
udakakapallake=udaka-kapallake
udapatte=uda-patte
udapānapanāḷiyatthiko=udapāna-panāḷi-atthiko
udapānapanāḷiṃ=udapāna-panāḷiṃ
udayabbayañca=udaya-bayañ-ca
udayabbayānupassinā=udaya-baya-anupassinā
uddesaaraṇā=uddesa-araṇā
uddhaccapariyuṭṭhitena=uddhacca-pariyuṭṭhitena
uddhaccapariyuṭṭhānaṃ=uddhacca-pariyuṭṭhānaṃ
uddhataavūpasantacittasandosahetu=uddhata-avūpasanta-citta-sandosahetu
uddhaṃkhitto=uddhaṃ-khitto
uddhaṃsotoakaniṭṭhagāmī=uddhaṃsoto-akaniṭṭhagāmī
udumbarakhādīvāyaṃ=udumbara-khādī-vāyaṃ
uggavādiniṃ=ugga-vādiniṃ
ujjhattibalā=ujjhatti-balā
ujugatikassa=uju-gatikassa
ujumaggeneva=uju-magge-neva
ujupapatti=uju-upapatti
ujupapattikassa=uju-upapatti-kassa
ukkiṇṇaparikhāsu=ukkiṇṇa-parikhāsu
ukkoṭanavañcana=ukkoṭana-vañcana
ummattakasaṃvattaniko=ummattaka-saṃvattaniko
unnāmaninnāmi=unnāma-ninnāmi
upadhikkhayaṃ=upadhi-khayaṃ
upahaccaparinibbāyissa=upahacca-parinibbāyissa
upajjhāyehi=upajjhā-yehi
upanidhampi=upanidham-pi
upanisasampannā=upanisa-sampannā
upanāhapariyuṭṭhitena=upanāha-pariyuṭṭhitena
upanāhapariyuṭṭhānaṃ=upanāha-pariyuṭṭhānaṃ
upapajjamāno=upapajja-māno
upapajjeyyāmā=upapajjeyyā-mā
upasampadanissayā=upasampada-nissayā
upasampadāsuttaṃ=upasampadā-suttaṃ
upasenaāsīvisasuttaṃ=upasenaāsīvisa-suttaṃ
upavāṇapañcamaṃ=upavāṇa-pañcamaṃ
upavāṇasuttaṃ=upavāṇa-suttaṃ
upaḍḍhadivasaṃ=upaḍḍha-divasaṃ
upaḍḍhapiṇḍapātaṃ=upaḍḍha-piṇḍapātaṃ
upaṭṭhitakāyassati=upaṭṭhita-kāyassa-ti
upaṭṭhitassatissāyaṃ=upaṭṭhitassatissa-ayaṃ
upaṭṭhitassatīti=upaṭṭhita-satī-ti
upekkhāsahagatā=upekkhā-sahagatā
upekkhāsukhe=upekkhā-sukhe
uposathapucchakañca=uposatha-puccha-kañca
uposathavaggo=uposatha-vaggo
uppādetabbadhammasuttaṃ=uppādetabba-dhamma-suttaṃ
uppādetabbasuttaṃ=uppādetabba-suttaṃ
uppādetabbañca=uppāde-tabbañca
upālivaggo=upāli-vaggo
upārambhacittataṃ=upārambha-cittataṃ
upāsikāsuttaṃ=upāsikā-suttaṃ
usabhachinnavisāṇasamena=usabha-chinna-visāṇa-samena
ussaṅkhapādauddhaggalomatālakkhaṇāni=ussaṅkhapāda-uddhaggalomatā-lakkhaṇāni
uttaravipattisuttaṃ=uttara-vipattisuttaṃ
uttarenābhimukhā=uttarena-abhimukhā
utupariṇāmajā=utu-pariṇāma-jā
uṇṇanābhī=uṇṇa-nābhī
uṭṭhānasampadā=uṭṭhāna-sampadā
uṭṭhānasampannoti=uṭṭhāna-sampanno-ti
vacanapatho=vacana-patho
vacchakā=vaccha-kā
vacīkamma=vacī-kamma
vacīkammanta=vacī-kammanta
vacīkammantasampatti=vacī-kammanta-sampatti
vacīkammantasandosabyāpatti=vacī-kammanta-sandosa-byāpatti
vacīsamācārena=vacī-samācārena
vacīsaṃvaro=vacī-saṃvaro
vadhabandhanaviparāmosa=vadha-bandhana-viparāmosa
vajjiyamāhitasuttaṃ=vajjiyamāhita-suttaṃ
vajjiyamāhituttiyā=vajjiyamāhita-uttiyā
vamanasuttaṃ=vamana-suttaṃ
vanabhaṅgena=vana-bhaṅgena
vanibbakayācakānaṃ=vanibbaka-yācakānaṃ
vassasahassameva=vassasahassam-eva
vassasatupasampanno=vassasata-upasampanno
vassasatūpasampannāya=vassasata-upasampannāya
vassaṃvuṭṭhāya=vassaṃ-vuṭṭhāya
vattemā=vatte-mā
vatthado=vattha-do
vatthuñca=vatthuñ-ca
vattitabba=vatti-tabba
vayañca=vayañ-ca
vayoanuppatte=vayo-anuppatte
vayoanuppatto=vayo-anuppatto
vayoanuppattā=vayo-anuppattā
vaḍḍhisuttaṃ=vaḍḍhi-suttaṃ
vaṇamukhassa=vaṇa-mukhassa
vaṇamukhaṃ=vaṇa-mukhaṃ
vaṇamukhe=vaṇa-mukhe
vaṇamukhānaṃ=vaṇa-mukhānaṃ
vaṇamukhāni=vaṇa-mukhāni
vaṇasāropī=vaṇa-sāropī
vaṇṇadhātu=vaṇṇa-dhātu
vaṇṇado=vaṇṇa-do
vaṇṇadāyī=vaṇṇa-dāyī
vaṇṇakāmena=vaṇṇa-kāmena
vaṇṇakāmo=vaṇṇa-kāmo
vaṇṇamaccharinī=vaṇṇa-maccharinī
vaṇṇamacchariyassa=vaṇṇa-macchariyassa
vaṇṇamacchariyaṃ=vaṇṇa-macchariyaṃ
vaṇṇamaccharī=vaṇṇa-maccharī
vaṇṇanibhaṃ=vaṇṇa-nibhaṃ
vaṇṇanibhā=vaṇṇa-nibhā
vaṇṇapaṭilābhāya=vaṇṇa-paṭilābhāya
vaṇṇapokkharatā=vaṇṇa-pokkharatā
vaṇṇapokkharatāya=vaṇṇa-pokkharatāya
vaṇṇarūpena=vaṇṇa-rūpena
vaṇṇasampanno=vaṇṇa-sampanno
vaṇṇasampannā=vaṇṇa-sampannā
vaṇṇasaṃvattanikaṃ=vaṇṇa-saṃvattanikaṃ
vaṇṇasaṃvattanikā=vaṇṇa-saṃvattanikā
vaṇṭapaṭibandhāni=vaṇṭa-paṭibandhāni
vedanāaññāṇasuttaṃ=vedanā-aññāṇa-suttaṃ
vedanāsamosaraṇā=vedanā-samosaraṇā
vediyāmā=vedi-yāmā
velāmasuttaṃ=velāma-suttaṃ
vepullasampadā=vepulla-sampadā
vepullāyaṃ=vepulla-yaṃ
veramaṇipaccayā=veramaṇi-paccayā
verañjasuttaṃ=verañja-suttaṃ
verocanaasurindasuttaṃ=verocana-asurinda-suttaṃ
vevaṇṇiyamhi=ve-vaṇṇi-yamhi
veyyākaraṇa=veyyā-karaṇa
veḷamissakena=veḷa-missakena
vibhavañca=vibhavañ-ca
vibhāvetvā=vibhāve-tvā
vicikicchāpariyuṭṭhānaṃ=vicikicchā-pariyuṭṭhānaṃ
vigataūmiko=vigata-ūmiko
viharathāti=viharathā-ti
viharissāmāti=viharissāmā-ti
vihiṃsāvitakkenā=vihiṃsā-vitakkenā
vihiṃsāvitakkenāti=vihiṃsā-vitakkenā-ti
vijjācaraṇasampanne=vijjā-caraṇa-sampanne
vijjāvimuttimpāhaṃ=vijjā-vimuttimpāhaṃ
vijjāvimuttiyā=vijjā-vimuttiyā
vikiṇṇavāco=vikiṇṇa-vāco
vikiṇṇavācā=vikiṇṇa-vācā
vimokkhasuttaṃ=vimokkha-suttaṃ
vimuccitabbāti=vimuccitabbā-ti
vimuttiraso=vimutti-raso
vimuttisārā=vimutti-sārā
vimuttiñāṇadassanakathāti=vimutti-ñāṇadassana-kathāti
vimuttiñāṇadassanattho=vimutti-ñāṇa-dassanattho
vimuttiñāṇadassanānisaṃso=vimutti-ñāṇa-dassana-ānisaṃso
vinibandhāti=vinibandhā-ti
vinīvaraṇacittaṃ=vinīvaraṇa-cittaṃ
vinīvaraṇacitte=vinīvaraṇa-citte
vinīvaraṇadassāvī=vinīvaraṇa-dassāvī
vipaccanīkavādānaṃ=vipaccanīka-vādānaṃ
vipariṇāmadhamma=vipariṇāma-dhamma
vipariṇāmadhamme=vipariṇāma-dhamme
vipubbakasaññā=vipubbaka-saññā
vipākasuttaṃ=vipāka-suttaṃ
virāgasampannassa=virāga-sampannassa
virāgasaññāparicitañca=virāga-saññā-paricitañ-ca
virāgavipannassa=virāga-vipannassa
virāgānisaṃsā=virāga-ānisaṃsā
visagilito=visa-gilito
visamacariyā=visama-cariyā
visamaparihārajā=visama-parihārajā
visamañca=visamañ-ca
visesaguṇā=visesa-guṇā
visākhāsuttaṃ=visākhā-suttaṃ
vitakkupacchedāya=vitakka-upacchedāya
vitthatūposathasuttaṃ=vitthatūposatha-suttaṃ
vitthāretabbaṃtadapi=vitthāretabbaṃ-tadapi
vitthāretabbaṃyathā=vitthāretabbaṃ-yathā
vivekaninnena=viveka-ninnena
vivādasuttaṃ=vivāda-suttaṃ
vivādatuvaṃtuvaṃ=vivāda-tuvaṃtuvaṃ
viññāṇaappaccakkhakammasuttaṃ=viññāṇa-appaccakkha-kamma-suttaṃ
viññāṇaaññāṇasuttaṃ=viññāṇa-aññāṇa-suttaṃ
viññāṇabhāgassa=viññāṇa-bhāgassa
viññāṇadhātu=viññāṇa-dhātu
viññāṇadhātuyā=viññāṇa-dhātuyā
viññāṇadhātuṃ=viññāṇa-dhātuṃ
viññāṇagataṃ=viññāṇa-gataṃ
viññāṇajātikaṃ=viññāṇa-jātikaṃ
viññāṇakasiṇasamāpattiparamatā=viññāṇa-kasiṇa-samāpatti-paramatā
viññāṇakasiṇasamāpattiparamā=viññāṇa-kasiṇa-samāpatti-paramā
viññāṇakasiṇaṃ=viññāṇa-kasiṇaṃ
viññāṇakāyā=viññāṇa-kāyā
viññāṇanidānaṃ=viññāṇa-nidānaṃ
viññāṇanirodhaṃ=viññāṇa-nirodhaṃ
viññāṇanirodhe=viññāṇa-nirodhe
viññāṇanirodho=viññāṇa-nirodho
viññāṇanirodhā=viññāṇa-nirodhā
viññāṇanissitaṃ=viññāṇa-nissitaṃ
viññāṇapabhavaṃ=viññāṇa-pabhavaṃ
viññāṇapaccayā=viññāṇa-paccayā
viññāṇaratassa=viññāṇa-ratassa
viññāṇasahagato=viññāṇa-sahagato
viññāṇasammuditassa=viññāṇa-sammuditassa
viññāṇasamudayaṃ=viññāṇa-samudayaṃ
viññāṇasamudaye=viññāṇa-samudaye
viññāṇasamudayo=viññāṇa-samudayo
viññāṇasamudayā=viññāṇa-samudayā
viññāṇasotaṃ=viññāṇa-sotaṃ
viññāṇasuttaṃ=viññāṇa-suttaṃ
viññāṇañcāyatanampi=viññāṇañcāyatanam-pi
viññāṇañcāyatanampāhaṃ=viññāṇañcāyatanam-pāhaṃ
viññāṇañcāyatanasaññī=viññāṇañcāyatana-saññī
viññāṇaṭṭhitīsu=viññāṇa-ṭhitīsu
vosānagamanaṃ=vosāna-gamanaṃ
vuddhasīlino=vuddha-sīlino
vuddhasīlo=vuddha-sīlo
vuḍḍhihesā=vuḍḍhi-hesā
vuḍḍhimetaṃ=vuḍḍhi-metaṃ
vuḍḍhiñca=vuḍḍhiñ-ca
vuṭṭhahāmipi=vuṭṭhahāmi-pi
vuṭṭhahāmipī=vuṭṭhahāmi-pī
vādapathātivattaṃ=vādapathāti-vattaṃ
vāhanasuttaṃ=vāhana-suttaṃ
vālabījaniṃ=vāla-bījaniṃ
vāmakase=vāmaka-se
vātasamuṭṭhānā=vāta-samuṭṭhānā
vātasamuṭṭhānānampi=vāta-samuṭṭhānānam-pi
vāteritāni=vāta-īritāni
vāyokasiṇasamāpattiparamā=vāyo-kasiṇa-samāpatti-paramā
vāyosamena=vāyo-samena
vāyosaññā=vāyo-saññā
vāyosaññī=vāyo-saññī
vāḷarajjuyā=vāḷa-rajjuyā
vāḷayakkhā=vāḷa-yakkhā
vīsativasso=vīsati-vasso
yamunodakena=yamuna-udakena
yasassine=yasassi-ne
yasasuttaṃ=yasa-suttaṃ
yasmāhaṃ=yasma-ahaṃ
yassapa=yassapa
yassaṃdisaṃsuttaṃ=yassaṃ-disaṃ-suttaṃ
yassu=yassu
yasāyaso=yasā-yaso
yatanaṃ=yata-naṃ
yatharivāhaṃ=yathariva-ahaṃ
yatharivāyaṃ=yathariva-ayaṃ
yathāakusalaṃ=yathā-akusalaṃ
yathāakusale=yathā-akusale
yathāakusalenā=yathā-akusalenā
yathābhūtañāṇadassanattho=yathābhūta-ñāṇa-dassanattho
yathābhūtañāṇadassanānisaṃso=yathābhūta-ñāṇa-dassana-ānisaṃso
yathābhūtañāṇaṃ=yathābhūta-ñāṇaṃ
yathāpabbajjāparicitañca=yathā-pabbajjā-paricitañ-ca
yathāsakāni=yathā-sakāni
yavadūsī=yava-dūsī
yavadūsīvāyaṃ=yavadūsī-vāyaṃ
yavakaraṇassa=yava-karaṇassa
yavakaraṇe=yava-karaṇe
yavakāraṇḍavo=yava-kāraṇḍavo
yavakāraṇḍavoti=yava-kāraṇḍavo-ti
yavapalāpo=yava-palāpo
yaññadeva=yañña-eva
yaññakathā=yañña-kathā
yaññakālo=yañña-kālo
yaññasampadaṃ=yañña-sampadaṃ
yaññasampadā=yañña-sampadā
yaññasampadāya=yañña-sampadāya
yaññasuttaṃ=yañña-suttaṃ
yaññavāṭassa=yañña-vāṭassa
yaññavāṭe=yañña-vāṭe
yaññavāṭo=yañña-vāṭo
yaṃabhisamparāyā=yaṃ-abhisamparāyā
yaṃdiṭṭhikā=yaṃ-diṭṭhikā
yenamidhekacce=yena-idhekacce
yogakkhemā=yoga-khemā
yojanasatikāpi=yojana-satikā-pi
yonisomanasikārampāhaṃ=yonisomanasikāram-pāhaṃ
yonisomanasikārassa=yoniso-manasikārassa
yonīsu=yonī-su
yānado=yāna-do
yāvatatthīti=yāvatatthī-ti
yāvatānanda=yāvatā-ānanda
yāvañcidaṃ=yāvañca-idaṃ
ñātīpi=ñātī-pi
ñāṇabhūto=ñāṇa-bhūto
ñāṇabhūtā=ñāṇa-bhūtā
ñāṇadassanato=ñāṇa-dassanato
ñāṇadassanaṃ=ñāṇa-dassanaṃ
ñāṇadassane=ñāṇa-dassane
ñāṇadassanena=ñāṇa-dassanena
ñāṇadassanāya=ñāṇa-dassanāya
ñāṇakaraṇo=ñāṇa-karaṇo
ñāṇakaraṇā=ñāṇa-karaṇā
ñāṇakaraṇī=ñāṇa-karaṇī
ñāṇasampannā=ñāṇa-sampannā
ñāṇasukhā=ñāṇa-sukhā
ñāṇasuttaṃ=ñāṇa-suttaṃ
ñāṇavatthūni=ñāṇa-vatthūni
ñāṇavatthūnī=ñāṇa-vatthūnī
ñāṇavādaṃ=ñāṇa-vādaṃ
ñāṇavādena=ñāṇa-vādena
ñāṇavādo=ñāṇa-vādo
ñāṇavādānaṃ=ñāṇa-vādānaṃ
ācariyāmahayugā=ācariyāmaha-yugā
ācayagāmisuttaṃ=ācaya-gāmi-suttaṃ
ācayagāmiñca=ācaya-gāmiñca
ācayagāmī=ācaya-gāmī
ādhānaggāhi=ādhāna-gāhi
ādānādhippāyā=ādāna-adhippāyā
ādīnavadassanahetu=ādīnava-dassana-hetu
ādīnavamaddasa=ādīnavam-addasa
ādīnavasaññāparicitañca=ādīnavasaññā-paricitañca
ādīnavānupassī=ādīnava-anupassī
āgaccheyyāhaṃ=āgaccheyya-āhaṃ
āghātapaṭivinayasuttaṃ=āghātapaṭivinaya-suttaṃ
āghātavatthusuttaṃ=āghāta-vatthu-suttaṃ
āghātāti=āghātā-ti
āhariṃsūti=āhariṃsu-ti
āhuneyyasuttaṃ=āhuneyya-suttaṃ
āhāranirodhagāminiṃ=āhāra-nirodhagāminiṃ
ājaññarathaṃ=ājañña-rathaṃ
ājaññaratho=ājañña-ratho
ājānīyabhojanañca=ājānīya-bhojanañ-ca
ājānīyajhāyitaṃ=ājānīya-jhāyitaṃ
ājānīyaparimajjanañca=ājānīya-parimajjanañ-ca
ājānīyaparimajjanaṃ=ājānīya-parimajjanaṃ
ājānīyaṭṭhāne=ājānīya-ṭhāne
ājīvasaṃvaro=ājīva-saṃvaro
ājīvikabhayassa=ājīvika-bhayassa
ājīvikabhayaṃ=ājīvika-bhayaṃ
ākaṅkhasuttaṃ=ākaṅkha-suttaṃ
ākaṅkhavaggo=ākaṅkha-vaggo
ākiñcaññāyatanameko=ākiñcaññāyatana-me-ko
ākiñcaññāyatanampi=ākiñcaññāyatanam-pi
ākiñcaññāyatanampāhaṃ=ākiñcaññāyatanam-pāhaṃ
ākiñcaññāyatanasaññī=ākiñcaññāyatana-saññī
ākiṇṇakammanto=ākiṇṇa-kammanto
ākiṇṇaluddo=ākiṇṇa-luddo
ākiṇṇamanussaṃ=ākiṇṇa-manussaṃ
ākiṇṇamanusso=ākiṇṇa-manusso
ākiṇṇamanussā=ākiṇṇa-manussā
ākiṇṇavihāre=ākiṇṇa-vihāre
ākiṇṇavihāro=ākiṇṇa-vihāro
ākiṇṇayakkhā=ākiṇṇa-yakkhā
ākāsakasiṇasamāpattiparamā=ākāsakasiṇa-samāpatti-paramā
ākāsasamaṃ=ākāsa-samaṃ
ākāsānañcāyatanampi=ākāsānañcāyatanam-pi
ākāsānañcāyatanampāhaṃ=ākāsānañcāyatanam-pāhaṃ
ākāsānañcāyatanasaññī=ākāsānañcāyatana-saññī
āmakadhañña=āmaka-dhañña
āmuttamaṇikuṇḍalāyo=āmutta-maṇi-kuṇḍalāyo
ānandaacchariyadhammo=ānanda-acchariya-dhammo
ānandaacchariyasuttaṃ=ānanda-acchariya-suttaṃ
āpajjitu=āpajji-tu
āpampi=āpam-pi
āpannomhi=āpanno-amhi
āpannomhī=āpanno-amhī
āpassa=āpa-assa
āpaṇasuttaṃ=āpaṇa-suttaṃ
āpokasiṇasamāpattiparamā=āpo-kasiṇa-samāpatti-paramā
āposamena=āpo-samena
āposaññī=āpo-saññī
āraggeriva=āragge-iva
ārakkhasampadā=ārakkha-sampadā
ārambhavatthūnī=ārambha-vatthūnī
ārammaṇakusalo=ārammaṇa-kusalo
ārammaṇamūlakaṃ=ārammaṇa-mūlakaṃ
āsabhiñca=āsabhiñ-ca
āsavakkhayoti=āsavakkhayo-ti
āsevitabbadhammasuttaṃ=āsevitabba-dhamma-suttaṃ
āsevitabbasuttaṃ=āsevitabba-suttaṃ
āsevitabbañca=āsevitabbañ-ca
āvaraṇanīvaraṇasuttaṃ=āvaraṇa-nīvaraṇa-suttaṃ
āvaraṇasuttaṃ=āvaraṇa-suttaṃ
āvasinettha=āvasin-ettha
āvaṭṭabhaya=āvaṭṭa-bhaya
āvaṭṭabhayassa=āvaṭṭa-bhayassa
āvaṭṭabhayaṃ=āvaṭṭa-bhayaṃ
āvudhabalā=āvudha-balā
āyasampannaṃ=āya-sampannaṃ
āyatakeneva=āyata-ke-neva
āyatikampi=āya-tika-mpi
āyañca=āyañ-ca
āḷavakoti=āḷavako-ti
ūsarañca=ūsarañ-ca
ḍahaññeva=ḍahañña-eva
ḍaṃsamakasavātātapasarīsa=ḍaṃsa-makasa-vātātapa-sarīsa
ṇupi=ṇu-pi
ṭhitadhammo=ṭhita-dhammo
ṭhitimetaṃ=ṭhitim-etaṃ
ṭhitimpāhaṃ=ṭhitim-pāhaṃ
ṭhitimūlakavuṭṭhānasuttādiaṭṭhakaṃ=ṭhiti-mūlaka-vuṭṭhāna-sutta-adi-aṭṭhakaṃ
ṭhitisuttaṃ=ṭhiti-suttaṃ
ṭhānasovetaṃ=ṭhānaso-evetaṃ